bill_id,roll_call_id,date,chamber,description,yea,nay,nv,absent,total
216544,219847,2011-07-18,House,"On Motion to Suspend the Rules and Pass, as Amended",310,1,120,0,431
216716,216556,2012-05-15,House,"On Motion to Suspend the Rules and Pass, as Amended",400,0,31,0,431
216716,220988,2012-05-15,House,"On Motion to Suspend the Rules and Pass, as Amended",400,0,31,0,431
216780,218633,2011-11-18,House,"On Motion to Suspend the Rules and Pass, as Amended",261,165,8,0,434
216801,220546,2011-01-05,House,"On Motion to Table",223,188,20,0,431
216801,220547,2011-01-05,House,"On Ordering the Previous Question",236,188,7,0,431
216801,220548,2011-01-05,House,"On Motion to Commit",191,238,2,0,431
216801,220549,2011-01-05,House,"On Agreeing to the Resolution",238,191,2,0,431
216805,221230,2011-01-20,House,"On Agreeing to the Amendment",428,1,5,0,434
216805,221231,2011-01-20,House,"On Agreeing to the Resolution",253,175,6,0,434
216818,220757,2011-01-06,House,"On Motion to Suspend the Rules and Agree",408,13,11,0,432
216822,221393,2011-01-07,House,"On Agreeing to the Resolution",257,159,18,0,434
216835,216711,2011-01-27,Senate,"On the Resolution S.Res. 8",12,84,4,0,100
216837,216647,2011-01-27,Senate,"On the Resolution S.Res. 10",44,51,5,0,100
227166,220236,2011-01-18,House,"On Motion to Suspend the Rules and Pass, as Amended",399,0,35,0,434
244857,219601,2011-01-19,House,"On Motion to Recommit with Instructions",185,245,4,0,434
244857,219602,2011-01-19,House,"On Passage",245,189,1,0,435
244858,221418,2011-05-04,House,"On Motion to Recommit with Instructions",192,235,5,0,432
244858,221419,2011-05-04,House,"On Passage",251,175,6,0,432
244859,216256,2011-04-05,Senate,"On the Amendment S.Amdt. 284 to H.R. 4 (Comprehensive 1099 Taxpayer Protection and Repayment of Exchange Subsidy Overpayments Act of 2011)",41,58,1,0,100
244859,216257,2011-04-05,Senate,"On Passage of the Bill H.R. 4",87,12,1,0,100
244859,220057,2011-03-03,House,"On Motion to Table the Appeal of the Ruling of the Chair",243,181,8,0,432
244859,220058,2011-03-03,House,"On Passage",314,112,6,0,432
244860,216851,2012-03-22,House,"On Agreeing to the Amendment",234,173,24,0,431
244860,216852,2012-03-22,House,"On Agreeing to the Amendment",179,228,24,0,431
244860,216853,2012-03-22,House,"On Agreeing to the Amendment",251,157,23,0,431
244860,216854,2012-03-22,House,"On Motion to Recommit with Instructions",180,229,22,0,431
244860,216855,2012-03-22,House,"On Passage",223,181,27,0,431
244860,218811,2012-03-22,House,"On Agreeing to the Amendment",234,173,24,0,431
244860,218812,2012-03-22,House,"On Agreeing to the Amendment",179,228,24,0,431
244860,218813,2012-03-22,House,"On Agreeing to the Amendment",251,157,23,0,431
244860,218814,2012-03-22,House,"On Motion to Recommit with Instructions",180,229,22,0,431
244860,218815,2012-03-22,House,"On Passage",223,181,27,0,431
244861,218949,2011-12-07,House,"On Agreeing to the Amendment",187,236,10,0,433
244861,218950,2011-12-07,House,"On Agreeing to the Amendment",183,238,12,0,433
244861,218951,2011-12-07,House,"On Agreeing to the Amendment",177,246,10,0,433
244861,218952,2011-12-07,House,"On Agreeing to the Amendment",177,242,14,0,433
244861,218953,2011-12-07,House,"On Agreeing to the Amendment",183,240,10,0,433
244861,218954,2011-12-07,House,"On Motion to Recommit with Instructions",183,235,15,0,433
244861,218955,2011-12-07,House,"On Passage",241,184,8,0,433
244863,220074,2011-11-14,House,"On Motion to Suspend the Rules and Pass",391,0,42,0,433
244885,220432,2011-10-24,House,"On Motion to Suspend the Rules and Pass",392,1,40,0,433
244912,216745,2012-02-27,House,"On Motion to Suspend the Rules and Concur in the Senate Amendment",388,3,42,0,433
244912,221266,2011-02-28,House,"On Motion to Suspend the Rules and Pass, as Amended",399,3,30,0,432
244912,221267,2012-02-27,House,"On Motion to Suspend the Rules and Concur in the Senate Amendment",388,3,42,0,433
244923,222107,2011-10-13,House,"On Motion to Recommit with Instructions",173,249,11,0,433
244923,222108,2011-10-13,House,"On Passage",251,172,10,0,433
244924,222009,2011-01-26,House,"On Agreeing to the Amendment",396,7,31,0,434
244924,222010,2011-01-26,House,"On Motion to Recommit with Instructions",173,228,33,0,434
244924,222011,2011-01-26,House,"On Passage",239,160,35,0,434
244930,216102,2012-05-15,House,"On Motion to Suspend the Rules and Pass, as Amended",394,1,36,0,431
244930,219562,2012-05-15,House,"On Motion to Suspend the Rules and Pass, as Amended",394,1,36,0,431
244933,219695,2011-02-28,House,"On Motion to Suspend the Rules and Pass, as Amended",396,4,32,0,432
244959,219586,2011-02-28,House,"On Motion to Suspend the Rules and Pass, as Amended",402,0,30,0,432
244963,219870,2011-08-01,House,"On Motion to Suspend the Rules and Pass",426,0,6,0,432
244983,220516,2011-01-07,House,"On Ordering the Previous Question",236,182,16,0,434
244983,220517,2011-01-07,House,"On Agreeing to the Resolution",236,181,17,0,434
244986,221158,2011-01-25,House,"On Motion to Recommit with Instructions",184,242,8,0,434
244986,221159,2011-01-25,House,"On Agreeing to the Resolution",256,165,13,0,434
244991,219929,2011-01-24,House,"On Ordering the Previous Question",238,174,22,0,434
244991,219930,2011-01-24,House,"On Agreeing to the Resolution",240,168,26,0,434
244997,220248,2011-01-25,House,"On Motion to Suspend the Rules and Agree",424,0,10,0,434
245002,220840,2011-01-26,House,"On Ordering the Previous Question",234,178,22,0,434
246629,220133,2011-11-01,House,"On Motion to Suspend the Rules and Agree",396,9,28,0,433
246883,216676,2011-01-27,Senate,"On the Resolution S.Res. 21",46,49,5,0,100
248535,216039,2011-02-02,Senate,"On the Amendment S.Amdt. 28 to S. 223 (FAA Air Transportation Modernization and Safety Improvement Act)",44,54,2,0,100
248535,216040,2011-02-02,Senate,"On the Motion (Motion to Waive All Applicable Budgetary Discipline Re: McConnell Amdt. No. 13)",47,51,2,0,100
248535,216041,2011-02-15,Senate,"On the Amendment S.Amdt. 14 to S. 223 (FAA Air Transportation Modernization and Safety Improvement Act)",47,51,2,0,100
248535,216042,2011-02-17,Senate,"On Passage of the Bill S. 223",87,8,5,0,100
248535,217047,2011-02-02,Senate,"On the Motion (Motion to Waive All Budgetary Discipline Re: Stabenow Amdt. No. 9)",81,17,2,0,100
248535,217048,2011-02-03,Senate,"On the Amendment S.Amdt. 8 to S. 223 (FAA Air Transportation Modernization and Safety Improvement Act)",96,1,3,0,100
248535,217049,2011-02-03,Senate,"On the Motion to Table S.Amdt. 19 to S. 223 (FAA Air Transportation Modernization and Safety Improvement Act)",55,42,3,0,100
248535,217050,2011-02-08,Senate,"On the Amendment S.Amdt. 34 to S. 223 (FAA Air Transportation Modernization and Safety Improvement Act)",96,1,3,0,100
248535,217051,2011-02-15,Senate,"On the Amendment S.Amdt. 58 to S. 223 (FAA Air Transportation Modernization and Safety Improvement Act)",98,0,2,0,100
248535,217052,2011-02-15,Senate,"On the Motion to Table S.Amdt. 21 to S. 223 (FAA Air Transportation Modernization and Safety Improvement Act)",51,47,2,0,100
248535,217053,2011-02-17,Senate,"On the Cloture Motion S. 223",96,2,2,0,100
248535,217054,2011-02-17,Senate,"On the Motion to Table S.Amdt. 4 to S. 223 (FAA Air Transportation Modernization and Safety Improvement Act)",61,38,1,0,100
248535,217055,2011-02-17,Senate,"On the Motion to Table S.Amdt. 18 to S. 223 (FAA Air Transportation Modernization and Safety Improvement Act)",52,47,1,0,100
248535,217056,2011-02-17,Senate,"On the Motion to Table S.Amdt. 80 to S. 223 (FAA Air Transportation Modernization and Safety Improvement Act)",34,65,1,0,100
248535,217057,2011-02-17,Senate,"On the Motion to Table S.Amdt. 91 to S. 223 (FAA Air Transportation Modernization and Safety Improvement Act)",59,40,1,0,100
248561,216491,2011-01-26,Senate,"On the Resolution S.Res. 14",97,0,3,0,100
248579,216646,2011-01-27,Senate,"On the Resolution S.Res. 29",81,15,4,0,100
250561,216119,2011-03-01,Senate,"On the Amendment S.Amdt. 121 to S. 23 (Patent Reform Act of 2011)",97,2,1,0,100
250561,216120,2011-03-01,Senate,"On the Motion to Table S.Amdt. 112 to S. 23 (Patent Reform Act of 2011)",52,47,1,0,100
250561,216121,2011-03-02,Senate,"On the Amendment S.Amdt. 115 to S. 23 (Patent Reform Act of 2011)",58,40,2,0,100
250561,216122,2011-03-03,Senate,"On the Motion to Table S.Amdt. 133 to S. 23 (Patent Reform Act of 2011)",87,13,0,0,100
250561,216123,2011-03-03,Senate,"On the Cloture Motion S. 23",87,3,10,0,100
250561,216124,2011-03-08,Senate,"On Passage of the Bill S. 23",95,5,0,0,100
250589,216759,2011-01-27,Senate,"On the Resolution S.Res. 28",92,4,4,0,100
251061,220046,2011-02-09,House,"On Motion to Suspend the Rules and Pass",429,0,5,0,434
252021,216937,2012-06-07,House,"On Motion to Recommit with Instructions",179,239,13,0,431
252021,216938,2012-06-07,House,"On Passage",270,146,15,0,431
252021,218995,2012-06-07,House,"On Motion to Recommit with Instructions",179,239,13,0,431
252021,218996,2012-06-07,House,"On Passage",270,146,15,0,431
252170,219909,2011-12-15,House,"On Motion to Suspend the Rules and Pass, as Amended",407,4,22,0,433
252170,219910,2013-01-01,House,"On Motion to Suspend the Rules and Concur in the Senate Amendment",410,5,16,0,431
253108,216433,2012-07-25,House,"On Motion to Suspend the Rules and Pass, as Amended",327,98,6,0,431
253108,220609,2012-07-25,House,"On Motion to Suspend the Rules and Pass, as Amended",327,98,6,0,431
253241,218847,2011-07-29,House,"On Motion to Suspend the Rules and Pass, as Amended",402,20,10,0,432
253244,216251,2011-02-15,Senate,"On Passage of the Bill H.R. 514",86,12,2,0,100
253244,220035,2011-02-08,House,"On Motion to Suspend the Rules and Pass",277,148,9,0,434
253244,220036,2011-02-14,House,"On Motion to Recommit with Instructions",186,234,13,0,433
253244,220037,2011-02-14,House,"On Passage",275,144,14,0,433
253244,220038,2011-02-17,House,"On Motion to Concur in the Senate Amendment",279,143,11,0,433
254786,220797,2011-03-30,House,"On Agreeing to the Amendment",185,237,10,0,432
254786,220798,2011-03-30,House,"On Motion to Recommit with Instructions",185,238,9,0,432
254786,220799,2011-03-30,House,"On Passage",225,195,12,0,432
260498,220805,2011-12-16,House,"On Motion to Suspend the Rules and Pass, as Amended",413,0,20,0,433
263768,221171,2011-02-10,House,"On Ordering the Previous Question",240,180,13,0,433
263768,221172,2011-02-10,House,"On Agreeing to the Resolution",255,169,9,0,433
263813,221391,2011-02-11,House,"On Motion to Recommit with Instructions",178,242,13,0,433
263813,221392,2011-02-11,House,"On Agreeing to the Resolution",391,28,14,0,433
264238,219935,2011-02-09,House,"On Motion to Suspend the Rules and Pass",259,169,6,0,434
265598,220427,2011-02-10,House,"On Agreeing to the Resolution",248,176,9,0,433
265710,219669,2011-03-08,House,"On Motion to Suspend the Rules and Pass",280,138,14,0,432
265800,220559,2011-12-01,House,"On Agreeing to the Amendment",173,244,16,0,433
265800,220560,2011-12-01,House,"On Agreeing to the Amendment",171,248,14,0,433
265800,220561,2011-12-01,House,"On Agreeing to the Amendment",179,243,11,0,433
265800,220562,2011-12-01,House,"On Agreeing to the Amendment",172,250,11,0,433
265800,220563,2011-12-01,House,"On Agreeing to the Amendment",170,250,13,0,433
265800,220564,2011-12-01,House,"On Motion to Recommit with Instructions",188,233,12,0,433
265800,220565,2011-12-01,House,"On Passage",263,159,11,0,433
267492,220135,2011-04-12,House,"On Motion to Suspend the Rules and Pass",408,3,21,0,432
267513,219821,2011-03-08,House,"On Motion to Suspend the Rules and Pass",401,12,19,0,432
268635,221672,2011-03-02,House,"On Agreeing to the Amendment",422,0,10,0,432
268635,221673,2011-03-02,House,"On Motion to Recommit with Instructions",181,246,5,0,432
268635,221674,2011-03-02,House,"On Passage",421,4,7,0,432
268754,216729,2011-03-09,Senate,"On Passage of the Bill H.R. 1",44,56,0,0,100
268754,216730,2011-03-09,Senate,"On the Amendment S.Amdt. 149 to H.R. 1 (Full-Year Continuing Appropriations Act, 2011)",42,58,0,0,100
268754,216731,2012-12-21,Senate,"On the Cloture Motion S.Amdt. 3395 to H.R. 1 (Full-Year Continuing Appropriations Act, 2011)",91,1,7,0,99
268754,216732,2012-12-21,Senate,"On the Motion (Motion to Waive Sec. 314(e)(1) of the Congressional Budget Act)",57,34,8,0,99
268754,216733,2012-12-28,Senate,"On the Amendment S.Amdt. 3344 to S.Amdt. 3395 to H.R. 1 (Full-Year Continuing Appropriations Act, 2011)",52,43,5,0,100
268754,216734,2012-12-28,Senate,"On the Motion (Motion to Waive All Applicable Budgetary Discipline Re: Tester Amdt. No. 3350)",51,44,5,0,100
268754,216735,2012-12-28,Senate,"On the Amendment S.Amdt. 3368 to S.Amdt. 3395 to H.R. 1 (Full-Year Continuing Appropriations Act, 2011)",44,51,5,0,100
268754,216736,2012-12-28,Senate,"On the Amendment S.Amdt. 3370 to S.Amdt. 3395 to H.R. 1 (Full-Year Continuing Appropriations Act, 2011)",35,60,5,0,100
268754,216737,2012-12-28,Senate,"On the Amendment S.Amdt. 3371 to S.Amdt. 3395 to H.R. 1 (Full-Year Continuing Appropriations Act, 2011)",40,55,5,0,100
268754,216738,2012-12-28,Senate,"On the Amendment S.Amdt. 3382 to S.Amdt. 3395 to H.R. 1 (Full-Year Continuing Appropriations Act, 2011)",48,47,5,0,100
268754,216739,2012-12-28,Senate,"On the Amendment S.Amdt. 3376 to S.Amdt. 3395 to H.R. 1 (Full-Year Continuing Appropriations Act, 2011)",42,52,6,0,100
268754,216740,2012-12-28,Senate,"On the Amendment S.Amdt. 3410 to S.Amdt. 3395 to H.R. 1 (Full-Year Continuing Appropriations Act, 2011)",3,91,6,0,100
268754,216741,2012-12-28,Senate,"On the Amendment S.Amdt. 3355 to S.Amdt. 3395 to H.R. 1 (Full-Year Continuing Appropriations Act, 2011)",46,49,5,0,100
268754,216742,2012-12-28,Senate,"On the Motion (Motion to Waive All Applicable Budgetary Discipline Re: Merkley Amdt. No. 3367, as Modified Further)",55,40,5,0,100
268754,216743,2012-12-28,Senate,"On the Amendment S.Amdt. 3391 to S.Amdt. 3395 to H.R. 1 (Full-Year Continuing Appropriations Act, 2011)",41,54,5,0,100
268754,216744,2012-12-28,Senate,"On Passage of the Bill H.R. 1",62,32,6,0,100
268754,221268,2011-02-15,House,"On Agreeing to the Amendment",207,223,3,0,433
268754,221269,2011-02-15,House,"On Agreeing to the Amendment",72,358,3,0,433
268754,221270,2011-02-15,House,"On Agreeing to the Amendment",105,326,2,0,433
268754,221271,2011-02-15,House,"On Agreeing to the Amendment",109,320,4,0,433
268754,221272,2011-02-16,House,"On Agreeing to the Amendment",233,198,2,0,433
268754,221273,2011-02-16,House,"On Agreeing to the Amendment",135,294,4,0,433
268754,221274,2011-02-16,House,"On Agreeing to the Amendment",133,299,1,0,433
268754,221275,2011-02-16,House,"On Agreeing to the Amendment",136,296,1,0,433
268754,221276,2011-02-16,House,"On Agreeing to the Amendment",305,127,1,0,433
268754,221277,2011-02-16,House,"On Agreeing to the Amendment",262,169,2,0,433
268754,221278,2011-02-16,House,"On Agreeing to the Amendment",184,247,2,0,433
268754,221279,2011-02-16,House,"On Agreeing to the Amendment",228,203,2,0,433
268754,221280,2011-02-16,House,"On Agreeing to the Amendment",171,259,3,0,433
268754,221281,2011-02-16,House,"On Agreeing to the Amendment",170,262,1,0,433
268754,221282,2011-02-16,House,"On Agreeing to the Amendment",159,273,1,0,433
268754,221283,2011-02-16,House,"On Agreeing to the Amendment",208,223,2,0,433
268754,221284,2011-02-16,House,"On Agreeing to the Amendment",137,293,3,0,433
268754,221285,2011-02-16,House,"On Agreeing to the Amendment",130,301,2,0,433
268754,221286,2011-02-16,House,"On Agreeing to the Amendment",318,113,2,0,433
268754,221287,2011-02-16,House,"On Agreeing to the Amendment",213,216,4,0,433
268754,221288,2011-02-16,House,"On Agreeing to the Amendment",73,352,8,0,433
268754,221289,2011-02-16,House,"On Agreeing to the Amendment",199,230,4,0,433
268754,221290,2011-02-16,House,"On Agreeing to the Amendment",239,185,9,0,433
268754,221291,2011-02-16,House,"On Agreeing to the Amendment",228,203,2,0,433
268754,221292,2011-02-17,House,"On Agreeing to the Amendment",171,256,6,0,433
268754,221293,2011-02-17,House,"On Agreeing to the Amendment",217,209,7,0,433
268754,221294,2011-02-17,House,"On Agreeing to the Amendment",248,177,8,0,433
268754,221295,2011-02-17,House,"On Agreeing to the Amendment",239,186,8,0,433
268754,221296,2011-02-17,House,"On Agreeing to the Amendment",104,322,7,0,433
268754,221297,2011-02-17,House,"On Agreeing to the Amendment",115,316,2,0,433
268754,221298,2011-02-17,House,"On Agreeing to the Amendment",249,179,5,0,433
268754,221299,2011-02-17,House,"On Agreeing to the Amendment",313,117,3,0,433
268754,221300,2011-02-17,House,"On Agreeing to the Amendment",176,250,7,0,433
268754,221301,2011-02-17,House,"On Agreeing to the Amendment",268,163,2,0,433
268754,221302,2011-02-17,House,"On Agreeing to the Amendment",274,155,4,0,433
268754,221303,2011-02-17,House,"On Agreeing to the Amendment",190,241,2,0,433
268754,221304,2011-02-17,House,"On Agreeing to the Amendment",176,250,7,0,433
268754,221305,2011-02-17,House,"On Agreeing to the Amendment",91,339,3,0,433
268754,221306,2011-02-17,House,"On Agreeing to the Amendment",247,175,11,0,433
268754,221307,2011-02-17,House,"On Agreeing to the Amendment",267,159,7,0,433
268754,221308,2011-02-17,House,"On Agreeing to the Amendment",244,181,8,0,433
268754,221309,2011-02-17,House,"On Agreeing to the Amendment",137,292,4,0,433
268754,221310,2011-02-17,House,"On Agreeing to the Amendment",232,197,4,0,433
268754,221311,2011-02-17,House,"On Agreeing to the Amendment",250,177,6,0,433
268754,221312,2011-02-17,House,"On Agreeing to the Amendment",249,179,5,0,433
268754,221313,2011-02-17,House,"On Agreeing to the Amendment",160,270,3,0,433
268754,221314,2011-02-17,House,"On Agreeing to the Amendment",163,265,5,0,433
268754,221315,2011-02-18,House,"On Agreeing to the Amendment",148,281,4,0,433
268754,221316,2011-02-18,House,"On Agreeing to the Amendment",98,331,4,0,433
268754,221317,2011-02-18,House,"On Agreeing to the Amendment",289,136,8,0,433
268754,221318,2011-02-18,House,"On Agreeing to the Amendment",240,185,8,0,433
268754,221319,2011-02-18,House,"On Agreeing to the Amendment",243,185,5,0,433
268754,221320,2011-02-18,House,"On Agreeing to the Amendment",196,231,6,0,433
268754,221321,2011-02-18,House,"On Agreeing to the Amendment",249,177,7,0,433
268754,221322,2011-02-18,House,"On Agreeing to the Amendment",239,187,7,0,433
268754,221323,2011-02-18,House,"On Agreeing to the Amendment",241,187,5,0,433
268754,221324,2011-02-18,House,"On Agreeing to the Amendment",237,191,5,0,433
268754,221325,2011-02-18,House,"On Agreeing to the Amendment",246,182,5,0,433
268754,221326,2011-02-18,House,"On Agreeing to the Amendment",183,246,4,0,433
268754,221327,2011-02-18,House,"On Agreeing to the Amendment",123,306,4,0,433
268754,221328,2011-02-18,House,"On Agreeing to the Amendment",147,281,5,0,433
268754,221329,2011-02-18,House,"On Agreeing to the Amendment",156,269,8,0,433
268754,221330,2011-02-18,House,"On Agreeing to the Amendment",68,357,8,0,433
268754,221331,2011-02-18,House,"On Agreeing to the Amendment",74,348,11,0,433
268754,221332,2011-02-18,House,"On Agreeing to the Amendment",177,243,13,0,433
268754,221333,2011-02-18,House,"On Agreeing to the Amendment",87,338,8,0,433
268754,221334,2011-02-18,House,"On Agreeing to the Amendment",174,251,8,0,433
268754,221335,2011-02-18,House,"On Agreeing to the Amendment",241,185,7,0,433
268754,221336,2011-02-18,House,"On Agreeing to the Amendment",215,210,8,0,433
268754,221337,2011-02-18,House,"On Agreeing to the Amendment",91,333,9,0,433
268754,221338,2011-02-18,House,"On Agreeing to the Amendment",227,197,9,0,433
268754,221339,2011-02-18,House,"On Agreeing to the Amendment",185,241,7,0,433
268754,221340,2011-02-18,House,"On Agreeing to the Amendment",277,149,7,0,433
268754,221341,2011-02-18,House,"On Agreeing to the Amendment",241,184,8,0,433
268754,221342,2011-02-18,House,"On Agreeing to the Amendment",32,394,7,0,433
268754,221343,2011-02-18,House,"On Agreeing to the Amendment",74,351,8,0,433
268754,221344,2011-02-18,House,"On Agreeing to the Amendment",239,186,8,0,433
268754,221345,2011-02-18,House,"On Agreeing to the Amendment",230,195,8,0,433
268754,221346,2011-02-18,House,"On Agreeing to the Amendment",241,184,8,0,433
268754,221347,2011-02-18,House,"On Agreeing to the Amendment",63,362,8,0,433
268754,221348,2011-02-18,House,"On Agreeing to the Amendment",237,189,7,0,433
268754,221349,2011-02-18,House,"On Agreeing to the Amendment",231,191,11,0,433
268754,221350,2011-02-19,House,"On Agreeing to the Amendment",261,158,14,0,433
268754,221351,2011-02-19,House,"On Agreeing to the Amendment",210,210,13,0,433
268754,221352,2011-02-19,House,"On Agreeing to the Amendment",233,187,13,0,433
268754,221353,2011-02-19,House,"On Agreeing to the Amendment",76,344,13,0,433
268754,221354,2011-02-19,House,"On Agreeing to the Amendment",235,185,13,0,433
268754,221355,2011-02-19,House,"On Agreeing to the Amendment",259,159,15,0,433
268754,221356,2011-02-19,House,"On Agreeing to the Amendment",245,176,12,0,433
268754,221357,2011-02-19,House,"On Agreeing to the Amendment",244,179,10,0,433
268754,221358,2011-02-19,House,"On Agreeing to the Amendment",191,230,12,0,433
268754,221359,2011-02-19,House,"On Agreeing to the Amendment",285,136,12,0,433
268754,221360,2011-02-19,House,"On Agreeing to the Amendment",240,182,11,0,433
268754,221361,2011-02-19,House,"On Agreeing to the Amendment",239,183,11,0,433
268754,221362,2011-02-19,House,"On Agreeing to the Amendment",234,187,12,0,433
268754,221363,2011-02-19,House,"On Agreeing to the Amendment",239,182,12,0,433
268754,221364,2011-02-19,House,"On Agreeing to the Amendment",209,213,11,0,433
268754,221365,2011-02-19,House,"On Agreeing to the Amendment",255,168,10,0,433
268754,221366,2011-02-19,House,"On Agreeing to the Amendment",239,183,11,0,433
268754,221367,2011-02-19,House,"On Agreeing to the Amendment",121,300,12,0,433
268754,221368,2011-02-19,House,"On Agreeing to the Amendment",93,328,12,0,433
268754,221369,2011-02-19,House,"On Agreeing to the Amendment",189,233,11,0,433
268754,221370,2011-02-19,House,"On Agreeing to the Amendment",235,187,11,0,433
268754,221371,2011-02-19,House,"On Motion to Recommit with Instructions",186,238,9,0,433
268754,221372,2011-02-19,House,"On Passage",235,189,9,0,433
271012,216226,2012-02-03,House,"On Agreeing to the Conference Report",248,169,15,0,432
271012,216227,2012-02-06,Senate,"On the Conference Report H.R. 658",75,20,5,0,100
271012,219998,2011-03-31,House,"On Agreeing to the Amendment",251,168,13,0,432
271012,219999,2011-03-31,House,"On Agreeing to the Amendment",120,303,9,0,432
271012,220000,2011-03-31,House,"On Agreeing to the Amendment",161,263,8,0,432
271012,220001,2011-03-31,House,"On Agreeing to the Amendment",174,241,17,0,432
271012,220002,2011-03-31,House,"On Agreeing to the Amendment",187,235,10,0,432
271012,220003,2011-03-31,House,"On Agreeing to the Amendment",195,227,10,0,432
271012,220004,2011-04-01,House,"On Agreeing to the Amendment",207,215,10,0,432
271012,220005,2011-04-01,House,"On Agreeing to the Amendment",178,243,11,0,432
271012,220006,2011-04-01,House,"On Agreeing to the Amendment",183,238,11,0,432
271012,220007,2011-04-01,House,"On Agreeing to the Amendment",206,220,6,0,432
271012,220008,2011-04-01,House,"On Agreeing to the Amendment",215,209,8,0,432
271012,220009,2011-04-01,House,"On Motion to Recommit with Instructions",184,235,13,0,432
271012,220010,2011-04-01,House,"On Passage",223,196,13,0,432
271012,220011,2012-02-03,House,"On Agreeing to the Conference Report",248,169,15,0,432
271371,216471,2012-03-20,House,"On Motion to Suspend the Rules and Pass, as Amended",403,0,28,0,431
271371,220652,2012-03-20,House,"On Motion to Suspend the Rules and Pass, as Amended",403,0,28,0,431
271547,220945,2011-10-03,House,"On Motion to Suspend the Rules and Pass",397,0,36,0,433
271774,222013,2011-02-15,House,"On Ordering the Previous Question",240,179,14,0,433
271774,222014,2011-02-15,House,"On Agreeing to the Resolution",242,174,17,0,433
271978,216186,2011-11-07,Senate,"On Cloture on the Motion to Proceed H.R. 674",94,1,5,0,100
271978,216187,2011-11-10,Senate,"On the Amendment S.Amdt. 928 to S.Amdt. 927 to H.R. 674 (No short title on file)",40,56,4,0,100
271978,216188,2011-11-10,Senate,"On the Amendment S.Amdt. 927 to H.R. 674 (No short title on file)",94,1,5,0,100
271978,216189,2011-11-10,Senate,"On Passage of the Bill H.R. 674",95,0,5,0,100
271978,219808,2011-10-27,House,"On Motion to Recommit with Instructions",183,235,15,0,433
271978,219809,2011-10-27,House,"On Passage",405,16,12,0,433
271978,219810,2011-11-16,House,"On Motion to Suspend the Rules and Concur in the Senate Amendment",422,0,11,0,433
273287,220329,2011-02-16,House,"On Agreeing to the Resolution",254,176,3,0,433
273314,219510,2011-06-22,House,"On Motion to Suspend the Rules and Pass, as Amended",235,187,9,0,431
273326,220705,2011-02-15,House,"On Agreeing to the Resolution",243,176,14,0,433
273442,220750,2011-10-03,House,"On Motion to Suspend the Rules and Pass, as Amended",400,0,33,0,433
279089,217000,2011-08-02,Senate,"On the Motion (Motion to Concur in the House Amendment to S. 365)",74,26,0,0,100
279089,219196,2011-08-01,House,"On Passage",269,161,3,0,433
279244,218747,2011-04-08,House,"On Consideration of the Joint Resolution",238,174,20,0,432
279244,218748,2011-04-08,House,"Table Appeal of the Ruling of the Chair",235,181,16,0,432
279244,218749,2011-04-08,House,"On Passage",240,179,13,0,432
285964,220654,2011-03-14,House,"On Motion to Suspend the Rules and Pass",394,0,38,0,432
286171,221232,2011-12-13,House,"On Motion to Suspend the Rules and Pass",417,1,15,0,433
286219,221590,2011-11-16,House,"On Agreeing to the Amendment",140,283,10,0,433
286219,221591,2011-11-16,House,"On Agreeing to the Amendment",147,274,12,0,433
286219,221592,2011-11-16,House,"On Agreeing to the Amendment",148,277,8,0,433
286219,221593,2011-11-16,House,"On Agreeing to the Amendment",139,284,10,0,433
286219,221594,2011-11-16,House,"On Agreeing to the Amendment",144,281,8,0,433
286219,221595,2011-11-16,House,"On Agreeing to the Amendment",150,276,7,0,433
286219,221596,2011-11-16,House,"On Agreeing to the Amendment",123,299,11,0,433
286219,221597,2011-11-16,House,"On Agreeing to the Amendment",146,277,10,0,433
286219,221598,2011-11-16,House,"On Motion to Recommit with Instructions",161,263,9,0,433
286219,221599,2011-11-16,House,"On Passage",272,154,7,0,433
286461,221222,2011-06-01,House,"On Motion to Suspend the Rules and Pass, as Amended",408,11,13,0,432
287045,220693,2011-05-13,House,"On Agreeing to the Amendment",224,174,33,0,431
287045,220694,2011-05-13,House,"On Agreeing to the Amendment",278,123,30,0,431
287045,220695,2011-05-13,House,"On Agreeing to the Amendment",194,214,23,0,431
287045,220696,2011-05-13,House,"On Agreeing to the Amendment",221,189,21,0,431
287045,220697,2011-05-13,House,"On Agreeing to the Amendment",406,0,25,0,431
287045,220698,2011-05-13,House,"On Motion to Recommit with Instructions",182,228,21,0,431
287045,220699,2011-05-13,House,"On Passage",392,15,24,0,431
287077,219615,2011-06-21,House,"On Motion to Suspend the Rules and Pass",398,0,34,0,432
287351,219545,2011-10-03,House,"On Motion to Suspend the Rules and Pass",394,0,39,0,433
287363,217064,2011-11-10,Senate,"On the Motion to Proceed S.J.Res. 6",46,52,2,0,100
287430,220929,2011-06-21,House,"On Motion to Suspend the Rules and Pass",397,0,35,0,432
287920,216225,2012-06-18,House,"On Motion to Suspend the Rules and Pass",380,0,51,0,431
287920,219997,2012-06-18,House,"On Motion to Suspend the Rules and Pass",380,0,51,0,431
291532,216200,2012-07-31,House,"On Motion to Suspend the Rules and Pass, as Amended",263,114,54,0,431
291532,219861,2012-07-31,House,"On Motion to Suspend the Rules and Pass, as Amended",263,114,54,0,431
291617,218944,2011-03-29,House,"On Agreeing to the Amendment",247,170,15,0,432
291617,218945,2011-03-29,House,"On Agreeing to the Amendment",182,239,11,0,432
291617,218946,2011-03-29,House,"On Agreeing to the Amendment",173,249,10,0,432
291617,218947,2011-03-29,House,"On Motion to Recommit with Instructions",185,238,9,0,432
291617,218948,2011-03-29,House,"On Passage",252,170,10,0,432
291661,218836,2011-03-10,House,"On Agreeing to the Amendment",184,243,5,0,432
291661,218837,2011-03-10,House,"On Agreeing to the Amendment",278,147,7,0,432
291661,218838,2011-03-10,House,"On Motion to Recommit with Instructions",185,243,4,0,432
291661,218839,2011-03-10,House,"On Passage",256,171,5,0,432
291785,219419,2011-03-01,House,"On Ordering the Previous Question",241,179,12,0,432
291785,219420,2011-03-01,House,"On Agreeing to the Resolution",251,170,11,0,432
292113,218939,2011-03-11,House,"On Agreeing to the Amendment",185,237,10,0,432
292113,218940,2011-03-11,House,"On Motion to Recommit with Instructions",182,238,12,0,432
292113,218941,2011-03-11,House,"On Passage",242,177,13,0,432
292267,216254,2011-03-02,Senate,"On the Joint Resolution H.J.Res. 44",91,9,0,0,100
292267,220068,2011-03-01,House,"On Motion to Recommit with Instructions",176,249,7,0,432
292267,220069,2011-03-01,House,"On Passage",335,91,6,0,432
292405,219822,2011-03-02,House,"On Ordering the Previous Question",243,185,4,0,432
292405,219823,2011-03-02,House,"On Agreeing to the Resolution",252,175,5,0,432
292422,219670,2011-03-02,House,"On Agreeing to the Resolution",256,169,7,0,432
292565,220276,2011-03-16,House,"On Motion to Rise and Recommend that the Enacting Clause Be Stricken",183,240,9,0,432
292565,220277,2011-03-16,House,"On Agreeing to the Amendment",183,244,5,0,432
292565,220278,2011-03-16,House,"On Agreeing to the Amendment",174,248,10,0,432
292565,220279,2011-03-16,House,"On Agreeing to the Amendment",178,249,5,0,432
292565,220280,2011-03-16,House,"On Agreeing to the Amendment",179,246,7,0,432
292565,220281,2011-03-16,House,"On Motion to Recommit with Instructions",153,272,7,0,432
292565,220282,2011-03-16,House,"On Passage",242,182,8,0,432
294341,216242,2012-03-21,House,"On Motion to Suspend the Rules and Concur in the Senate Amendment",409,2,20,0,431
294341,220028,2011-12-15,House,"On Motion to Suspend the Rules and Pass, as Amended",412,1,20,0,433
294341,220029,2012-03-21,House,"On Motion to Suspend the Rules and Concur in the Senate Amendment",409,2,20,0,431
294373,221225,2011-03-31,House,"On Motion to Suspend the Rules and Pass, as Amended",292,130,10,0,432
295946,216985,2011-03-14,Senate,"On the Motion to Proceed S. 493",84,12,4,0,100
295946,216986,2011-03-16,Senate,"On the Amendment S.Amdt. 182 to S. 493 (SBIR/STTR Reauthorization Act of 2011)",98,1,1,0,100
295946,216987,2011-03-16,Senate,"On the Amendment S.Amdt. 193 to S. 493 (SBIR/STTR Reauthorization Act of 2011)",99,0,1,0,100
295946,216988,2011-03-16,Senate,"On the Amendment S.Amdt. 216 to S. 493 (SBIR/STTR Reauthorization Act of 2011)",99,0,1,0,100
295946,216989,2011-04-05,Senate,"On the Motion to Table S. 493",90,10,0,0,100
295946,216990,2011-04-06,Senate,"On the Amendment S.Amdt. 236 to S. 493 (SBIR/STTR Reauthorization Act of 2011)",7,93,0,0,100
295946,216991,2011-04-06,Senate,"On the Amendment S.Amdt. 277 to S. 493 (SBIR/STTR Reauthorization Act of 2011)",7,93,0,0,100
295946,216992,2011-04-06,Senate,"On the Amendment S.Amdt. 215 to S. 493 (SBIR/STTR Reauthorization Act of 2011)",12,88,0,0,100
295946,216993,2011-04-06,Senate,"On the Amendment S.Amdt. 183 to S. 493 (SBIR/STTR Reauthorization Act of 2011)",50,50,0,0,100
295946,216994,2011-04-06,Senate,"On the Amendment S.Amdt. 281 to S. 493 (SBIR/STTR Reauthorization Act of 2011)",100,0,0,0,100
295946,216995,2011-04-06,Senate,"On the Amendment S.Amdt. 286 to S. 493 (SBIR/STTR Reauthorization Act of 2011)",57,43,0,0,100
295946,216996,2011-04-06,Senate,"On the Amendment S.Amdt. 273 to S. 493 (SBIR/STTR Reauthorization Act of 2011)",64,36,0,0,100
295946,216997,2011-05-02,Senate,"On the Cloture Motion S. 493",52,44,3,0,99
296092,220223,2011-04-06,House,"On Agreeing to the Amendment",161,259,12,0,432
296092,220224,2011-04-06,House,"On Agreeing to the Amendment",157,266,9,0,432
296092,220225,2011-04-06,House,"On Agreeing to the Amendment",182,240,10,0,432
296092,220226,2011-04-06,House,"On Agreeing to the Amendment",184,240,8,0,432
296092,220227,2011-04-06,House,"On Agreeing to the Amendment",168,257,7,0,432
296092,220228,2011-04-06,House,"On Agreeing to the Amendment",156,266,10,0,432
296092,220229,2011-04-06,House,"On Agreeing to the Amendment",165,260,7,0,432
296092,220230,2011-04-06,House,"On Agreeing to the Amendment",173,250,9,0,432
296092,220231,2011-04-06,House,"On Agreeing to the Amendment",160,264,8,0,432
296092,220232,2011-04-07,House,"On Motion to Recommit with Instructions",175,251,6,0,432
296092,220233,2011-04-07,House,"On Passage",255,172,5,0,432
296101,216485,2012-05-30,House,"On Motion to Suspend the Rules and Pass, as Amended",391,2,38,0,431
296101,216486,2012-11-27,House,"On motion to Suspend the Rules and Concur in the Senate Amendment",397,4,31,0,432
296101,220718,2012-05-30,House,"On Motion to Suspend the Rules and Pass, as Amended",391,2,38,0,431
296101,220719,2012-11-27,House,"On motion to Suspend the Rules and Concur in the Senate Amendment",397,4,31,0,432
296944,220312,2011-03-14,House,"On Motion to Suspend the Rules and Agree",396,0,36,0,432
296957,219661,2011-03-09,House,"On Ordering the Previous Question",235,186,11,0,432
296957,219662,2011-03-09,House,"On Agreeing to the Resolution",240,180,12,0,432
298447,220260,2011-03-17,House,"On Agreeing to the Resolution",93,321,18,0,432
298876,216258,2011-03-17,Senate,"On the Joint Resolution H.J.Res. 48",87,13,0,0,100
298876,220055,2011-03-15,House,"On Motion to Recommit with Instructions",190,239,3,0,432
298876,220056,2011-03-15,House,"On Passage",271,158,3,0,432
298921,216581,2012-01-25,House,"On Motion to Suspend the Rules and Pass",338,70,25,0,433
298921,221039,2012-01-25,House,"On Motion to Suspend the Rules and Pass",338,70,25,0,433
300310,220051,2011-04-07,House,"Table Appeal of the Ruling of the Chair",236,187,9,0,432
300310,220052,2011-04-07,House,"On Motion to Recommit with Instructions",191,236,5,0,432
300310,220053,2011-04-07,House,"On Passage",247,181,4,0,432
300310,220054,2011-04-09,House,"On Motion to Concur in the Senate Amendment",348,70,14,0,432
300333,219182,2011-05-23,House,"On Motion to Suspend the Rules and Pass, as Amended",389,0,42,0,431
300333,219183,2011-07-25,House,"On Motion to Suspend the Rules and Concur in the Senate Amendments",424,0,8,0,432
300588,219437,2011-04-04,House,"On Motion to Suspend the Rules and Pass",393,0,39,0,432
300715,220105,2011-05-05,House,"On Agreeing to the Amendment",174,240,18,0,432
300715,220106,2011-05-05,House,"On Agreeing to the Amendment",176,240,16,0,432
300715,220107,2011-05-05,House,"On Motion to Recommit with Instructions",171,238,23,0,432
300715,220108,2011-05-05,House,"On Passage",266,149,17,0,432
301349,219442,2011-04-13,House,"On Agreeing to the Amendment",187,237,8,0,432
301349,219443,2011-04-13,House,"On Agreeing to the Amendment",188,238,6,0,432
301349,219444,2011-04-13,House,"On Motion to Recommit with Instructions",189,234,9,0,432
301349,219445,2011-04-13,House,"On Passage",236,183,13,0,432
301395,216844,2012-01-23,House,"On Motion to Suspend the Rules and Pass",278,100,55,0,433
301395,218792,2012-01-23,House,"On Motion to Suspend the Rules and Pass",278,100,55,0,433
301517,216107,2011-06-29,Senate,"On the Amendment S.Amdt. 521 to S.Res. 116 (No short title on file)",63,34,3,0,100
301517,216108,2011-06-29,Senate,"On the Resolution S.Res. 116",89,8,3,0,100
301744,216259,2011-04-14,Senate,"On Passage of the Bill H.R. 1473",81,19,0,0,100
301744,220049,2011-04-14,House,"On Passage",260,167,6,0,433
301839,216264,2012-02-01,House,"On Agreeing to the Amendment",161,263,8,0,432
301839,216265,2012-02-01,House,"On Agreeing to the Amendment",157,264,11,0,432
301839,216266,2012-02-01,House,"On Agreeing to the Amendment",164,260,8,0,432
301839,216267,2012-02-01,House,"On Agreeing to the Amendment",160,264,8,0,432
301839,216268,2012-02-01,House,"On Motion to Recommit with Instructions",175,247,10,0,432
301839,216269,2012-02-01,House,"On Passage",267,159,6,0,432
301839,220121,2012-02-01,House,"On Agreeing to the Amendment",161,263,8,0,432
301839,220122,2012-02-01,House,"On Agreeing to the Amendment",157,264,11,0,432
301839,220123,2012-02-01,House,"On Agreeing to the Amendment",164,260,8,0,432
301839,220124,2012-02-01,House,"On Agreeing to the Amendment",160,264,8,0,432
301839,220125,2012-02-01,House,"On Motion to Recommit with Instructions",175,247,10,0,432
301839,220126,2012-02-01,House,"On Passage",267,159,6,0,432
301866,216866,2011-04-14,Senate,"On the Concurrent Resolution H.Con.Res. 35",47,53,0,0,100
301866,218841,2011-04-14,House,"On Agreeing to the Resolution",240,185,7,0,432
302337,220368,2011-04-12,House,"On Motion to Suspend the Rules and Pass",394,18,20,0,432
302988,220521,2011-03-16,House,"On Agreeing to the Resolution",241,180,11,0,432
303077,220504,2011-03-17,House,"On Motion to Recommit with Instructions",184,235,13,0,432
303077,220505,2011-03-17,House,"On Passage",228,192,12,0,432
303322,221233,2011-03-30,House,"On Ordering the Previous Question",237,182,13,0,432
303322,221234,2011-03-30,House,"On Agreeing to the Resolution",235,178,19,0,432
303521,216911,2011-04-14,Senate,"On the Concurrent Resolution H.Con.Res. 36",42,58,0,0,100
303521,218957,2011-04-14,House,"On Agreeing to the Resolution",241,185,6,0,432
303632,219619,2011-05-24,House,"On Motion that the Committee Rise",14,397,20,0,431
303632,219620,2011-05-24,House,"On Agreeing to the Amendment",186,231,14,0,431
303632,219621,2011-05-24,House,"On Agreeing to the Amendment",182,232,17,0,431
303632,219622,2011-05-25,House,"On Agreeing to the Amendment",234,182,15,0,431
303632,219623,2011-05-25,House,"On Motion to Recommit with Instructions",184,236,11,0,431
303632,219624,2011-05-25,House,"On Passage",234,185,12,0,431
303650,218969,2011-04-13,House,"On Ordering the Previous Question",242,183,7,0,432
303650,218970,2011-04-13,House,"On Agreeing to the Resolution",241,179,12,0,432
303763,221161,2011-07-12,House,"On Agreeing to the Amendment",195,230,6,0,431
303763,221162,2011-07-12,House,"On Agreeing to the Amendment",118,305,8,0,431
303763,221163,2011-07-12,House,"On Agreeing to the Amendment",261,163,7,0,431
303763,221164,2011-07-12,House,"On Agreeing to the Amendment",241,183,7,0,431
303763,221165,2011-07-12,House,"On Agreeing to the Amendment",186,238,7,0,431
303763,221166,2011-07-12,House,"On Agreeing to the Amendment",192,230,9,0,431
303763,221167,2011-07-12,House,"On Agreeing to the Amendment",38,384,9,0,431
303763,221168,2011-07-12,House,"On Motion to Recommit with Instructions",181,244,6,0,431
303763,221169,2011-07-12,House,"On Passage",406,22,3,0,431
303856,219566,2011-10-24,House,"On Motion to Suspend the Rules and Pass, as Amended",395,0,38,0,433
303944,216221,2012-02-06,House,"On Motion to Suspend the Rules and Pass, as Amended",381,7,44,0,432
303944,219976,2012-02-06,House,"On Motion to Suspend the Rules and Pass, as Amended",381,7,44,0,432
304412,218818,2011-05-11,House,"On Agreeing to the Amendment",193,228,10,0,431
304412,218819,2011-05-11,House,"On Agreeing to the Amendment",189,238,4,0,431
304412,218820,2011-05-11,House,"On Agreeing to the Amendment",186,240,5,0,431
304412,218821,2011-05-12,House,"On Agreeing to the Amendment",195,223,13,0,431
304412,218822,2011-05-12,House,"On Agreeing to the Amendment",134,279,18,0,431
304412,218823,2011-05-12,House,"On Agreeing to the Amendment",156,263,12,0,431
304412,218824,2011-05-12,House,"On Agreeing to the Amendment",160,256,15,0,431
304412,218825,2011-05-12,House,"On Motion to Recommit with Instructions",180,243,8,0,431
304412,218826,2011-05-12,House,"On Passage",243,179,9,0,431
304449,219894,2011-05-03,House,"On Agreeing to the Amendment",177,239,16,0,432
304449,219895,2011-05-03,House,"On Agreeing to the Amendment",178,242,12,0,432
304449,219896,2011-05-03,House,"On Agreeing to the Amendment",180,242,10,0,432
304449,219897,2011-05-03,House,"On Motion to Recommit with Instructions",190,233,9,0,432
304449,219898,2011-05-03,House,"On Passage",238,183,11,0,432
304688,219764,2011-04-01,House,"On Motion to Recommit with Instructions",188,237,7,0,432
304688,219765,2011-04-01,House,"On Passage",221,202,9,0,432
304802,220370,2011-04-01,House,"On Consideration of the Resolution",219,172,41,0,432
304802,220371,2011-04-01,House,"On Ordering the Previous Question",230,187,15,0,432
304802,220372,2011-04-01,House,"On Agreeing to the Resolution",229,187,16,0,432
304957,220319,2011-04-14,House,"On Agreeing to the Resolution",243,178,11,0,432
304976,219063,2011-04-13,House,"On Ordering the Previous Question",238,182,12,0,432
304976,219064,2011-04-13,House,"On Agreeing to the Resolution",237,180,15,0,432
304993,221040,2011-05-10,House,"On Agreeing to the Amendment",167,245,19,0,431
304993,221041,2011-05-10,House,"On Agreeing to the Amendment",169,240,22,0,431
304993,221042,2011-05-10,House,"On Agreeing to the Amendment",176,237,18,0,431
304993,221043,2011-05-11,House,"On Agreeing to the Amendment",187,235,9,0,431
304993,221044,2011-05-11,House,"On Agreeing to the Amendment",179,247,5,0,431
304993,221045,2011-05-11,House,"On Agreeing to the Amendment",174,254,3,0,431
304993,221046,2011-05-11,House,"On Agreeing to the Amendment",169,258,4,0,431
304993,221047,2011-05-11,House,"On Agreeing to the Amendment",205,222,4,0,431
304993,221048,2011-05-11,House,"On Agreeing to the Amendment",185,239,7,0,431
304993,221049,2011-05-11,House,"On Motion to Recommit with Instructions",186,239,6,0,431
304993,221050,2011-05-11,House,"On Passage",263,163,5,0,431
305682,216558,2011-05-02,Senate,"On the Motion to Proceed H.Con.Res. 34",40,57,3,0,100
305682,221004,2011-04-15,House,"On Agreeing to the Amendment",103,303,26,0,432
305682,221005,2011-04-15,House,"On Agreeing to the Amendment",77,347,8,0,432
305682,221006,2011-04-15,House,"On Agreeing to the Amendment",119,136,177,0,432
305682,221007,2011-04-15,House,"On Agreeing to the Amendment",166,259,7,0,432
305682,221008,2011-04-15,House,"On Agreeing to the Resolution",235,193,4,0,432
306279,219767,2011-04-07,House,"On Ordering the Previous Question",238,185,9,0,432
306279,219768,2011-04-07,House,"On Agreeing to the Resolution",228,189,15,0,432
306603,216972,2011-08-02,Senate,"On the Cloture Motion H.R. 1249",93,5,2,0,100
306603,216973,2011-09-08,Senate,"On the Amendment S.Amdt. 600 to H.R. 1249 (Leahy-Smith America Invents Act)",47,51,2,0,100
306603,216974,2011-09-08,Senate,"On the Amendment S.Amdt. 595 to H.R. 1249 (Leahy-Smith America Invents Act)",13,85,2,0,100
306603,216975,2011-09-08,Senate,"On the Motion to Table S.Amdt. 599 to H.R. 1249 (Leahy-Smith America Invents Act)",50,48,2,0,100
306603,216976,2011-09-08,Senate,"On Passage of the Bill H.R. 1249",89,9,2,0,100
306603,219136,2011-06-23,House,"On Agreeing to the Amendment",283,140,8,0,431
306603,219137,2011-06-23,House,"On Agreeing to the Amendment",105,316,10,0,431
306603,219138,2011-06-23,House,"On Agreeing to the Amendment",81,342,8,0,431
306603,219139,2011-06-23,House,"On Agreeing to the Amendment",223,198,10,0,431
306603,219140,2011-06-23,House,"On Agreeing to the Amendment",129,295,7,0,431
306603,219141,2011-06-23,House,"On Agreeing to the Amendment",92,329,10,0,431
306603,219142,2011-06-23,House,"On Agreeing to the Amendment",81,342,8,0,431
306603,219143,2011-06-23,House,"On Agreeing to the Amendment",158,262,11,0,431
306603,219144,2011-06-23,House,"On Motion to Recommit with Instructions",172,251,8,0,431
306603,219145,2011-06-23,House,"On Passage",304,117,10,0,431
306978,216304,2011-07-29,Senate,"On the Motion to Table S. 627",59,41,0,0,100
306978,216305,2011-07-31,Senate,"On the Cloture Motion S. 627",50,49,1,0,100
306978,220216,2011-07-29,House,"On Motion to Recommit with Instructions",183,244,5,0,432
306978,220217,2011-07-29,House,"On Passage",218,210,5,0,433
307693,220570,2011-03-15,House,"On Agreeing to the Resolution",232,197,3,0,432
307781,220962,2011-04-05,House,"On Ordering the Previous Question",241,175,16,0,432
307781,220963,2011-04-05,House,"On Agreeing to the Resolution",241,178,13,0,432
307840,219858,2011-04-06,House,"On Ordering the Previous Question",266,158,8,0,432
307840,219859,2011-04-06,House,"On Agreeing to the Resolution",250,172,10,0,432
308081,220586,2011-03-15,House,"On Agreeing to the Resolution",241,181,10,0,432
308164,221071,2011-12-08,House,"On Agreeing to the Amendment",150,255,28,0,433
308164,221072,2011-12-08,House,"On Agreeing to the Amendment",159,250,24,0,433
308164,221073,2011-12-08,House,"On Agreeing to the Amendment",165,249,19,0,433
308164,221074,2011-12-08,House,"On Agreeing to the Amendment",158,257,18,0,433
308164,221075,2011-12-08,House,"On Agreeing to the Amendment",170,247,16,0,433
308164,221076,2011-12-08,House,"On Motion to Recommit with Instructions",166,252,15,0,433
308164,221077,2011-12-08,House,"On Passage",268,150,15,0,433
308206,221227,2011-12-08,House,"On Motion to Suspend the Rules and Pass, as Amended",317,98,18,0,433
310469,218884,2011-03-31,House,"On Agreeing to the Resolution",249,171,12,0,432
310511,216244,2012-07-31,House,"On Motion to Suspend the Rules and Pass",261,116,54,0,431
310511,216245,2011-06-23,Senate,"On the Amendment S.Amdt. 499 to S. 679 (Presidential Appointment Efficiency and Streamlining Act of 2011)",47,51,2,0,100
310511,216246,2011-06-23,Senate,"On the Amendment S.Amdt. 510 to S. 679 (Presidential Appointment Efficiency and Streamlining Act of 2011)",41,57,2,0,100
310511,216247,2011-06-29,Senate,"On the Amendment S.Amdt. 501 to S. 679 (Presidential Appointment Efficiency and Streamlining Act of 2011)",44,55,1,0,100
310511,216248,2011-06-29,Senate,"On the Amendment S.Amdt. 511 to S. 679 (Presidential Appointment Efficiency and Streamlining Act of 2011)",25,74,1,0,100
310511,216249,2011-06-29,Senate,"On Passage of the Bill S. 679",79,20,1,0,100
310511,220039,2012-07-31,House,"On Motion to Suspend the Rules and Pass",261,116,54,0,431
311186,219372,2011-09-21,House,"On Motion to Suspend the Rules and Pass",407,2,24,0,433
311285,220554,2011-03-17,House,"On Ordering the Previous Question",233,179,20,0,432
311285,220555,2011-03-17,House,"On Agreeing to the Resolution",236,181,15,0,432
311467,216790,2012-04-25,House,"On Motion to Suspend the Rules and Pass, as Amended",421,1,9,0,431
311467,221620,2012-04-25,House,"On Motion to Suspend the Rules and Pass, as Amended",421,1,9,0,431
311559,221413,2011-05-04,House,"On Agreeing to the Amendment",207,218,7,0,432
311559,221414,2011-05-04,House,"On Agreeing to the Amendment",205,210,17,0,432
311559,221415,2011-05-04,House,"On Motion to Recommit with Instructions",180,230,22,0,432
311559,221416,2011-05-04,House,"On Passage",235,191,6,0,432
312245,217035,2012-03-28,House,"On Motion to Suspend the Rules and Pass, as Amended",413,6,12,0,431
312245,219415,2012-03-28,House,"On Motion to Suspend the Rules and Pass, as Amended",413,6,12,0,431
312464,219924,2011-09-12,House,"On Motion to Suspend the Rules and Pass",384,0,47,0,431
312557,216224,2012-06-18,House,"On Motion to Suspend the Rules and Pass",383,3,45,0,431
312557,219993,2012-06-18,House,"On Motion to Suspend the Rules and Pass",383,3,45,0,431
314107,219403,2011-12-14,House,"On Motion to Suspend the Rules and Pass, as Amended",418,1,14,0,433
314221,220713,2011-11-02,House,"On Motion to Suspend the Rules and Pass, as Amended",421,1,11,0,433
314619,221051,2011-05-31,House,"On Motion to Suspend the Rules and Pass, as Amended",419,1,11,0,431
314630,216799,2011-06-08,Senate,"On the Amendment S.Amdt. 392 to S. 782 (Economic Development Revitalization Act of 2011)",54,45,1,0,100
314630,216800,2011-06-09,Senate,"On the Amendment S.Amdt. 390 to S. 782 (Economic Development Revitalization Act of 2011)",53,46,1,0,100
314630,216801,2011-06-14,Senate,"On the Cloture Motion S.Amdt. 436 to S. 782 (Economic Development Revitalization Act of 2011)",40,59,1,0,100
314630,216802,2011-06-16,Senate,"On the Amendment S.Amdt. 476 to S. 782 (Economic Development Revitalization Act of 2011)",73,27,0,0,100
314630,216803,2011-06-16,Senate,"On the Amendment S.Amdt. 411 to S. 782 (Economic Development Revitalization Act of 2011)",41,59,0,0,100
314630,216804,2011-06-21,Senate,"On the Cloture Motion S. 782",49,51,0,0,100
315718,219679,2011-04-14,House,"On Ordering the Previous Question",238,183,11,0,432
315718,219680,2011-04-14,House,"On Agreeing to the Resolution",243,181,8,0,432
316781,216840,2011-12-14,Senate,"On the Joint Resolution S.J.Res. 10",47,53,0,0,100
317047,220268,2011-05-02,House,"On Motion to Suspend the Rules and Pass",399,0,33,0,432
317342,220097,2011-07-21,House,"On Agreeing to the Amendment",170,239,23,0,432
317342,220098,2011-07-21,House,"On Agreeing to the Amendment",175,238,19,0,432
317342,220099,2011-07-21,House,"On Agreeing to the Amendment",175,240,17,0,432
317342,220100,2011-07-21,House,"On Agreeing to the Amendment",168,244,20,0,432
317342,220101,2011-07-21,House,"On Agreeing to the Amendment",246,167,19,0,432
317342,220102,2011-07-21,House,"On Motion to Recommit with Instructions",183,232,17,0,432
317342,220103,2011-07-21,House,"On Passage",241,173,18,0,432
319872,219631,2011-06-21,House,"On Motion to Suspend the Rules and Pass",396,0,36,0,432
320253,219429,2011-05-23,House,"On Motion to Suspend the Rules and Pass, as Amended",380,0,51,0,431
320315,218886,2011-05-23,House,"On Motion to Suspend the Rules and Pass",385,1,45,0,431
326076,216782,2011-12-15,Senate,"On the Conference Report H.R. 1540",86,13,1,0,100
326076,221526,2011-05-25,House,"On Agreeing to the Amendment",83,334,14,0,431
326076,221527,2011-05-25,House,"On Agreeing to the Amendment",203,213,15,0,431
326076,221528,2011-05-25,House,"On Agreeing to the Amendment",198,225,8,0,431
326076,221529,2011-05-25,House,"On Agreeing to the Amendment",208,212,11,0,431
326076,221530,2011-05-25,House,"On Agreeing to the Amendment",261,163,7,0,431
326076,221531,2011-05-25,House,"On Agreeing to the Amendment",168,256,7,0,431
326076,221532,2011-05-25,House,"On Agreeing to the Amendment",176,248,7,0,431
326076,221533,2011-05-25,House,"On Agreeing to the Amendment",184,240,7,0,431
326076,221534,2011-05-25,House,"On Agreeing to the Amendment",191,232,8,0,431
326076,221535,2011-05-25,House,"On Agreeing to the Amendment",178,246,7,0,431
326076,221536,2011-05-25,House,"On Agreeing to the Amendment",177,246,8,0,431
326076,221537,2011-05-26,House,"On Agreeing to the Amendment",260,160,11,0,431
326076,221538,2011-05-26,House,"On Agreeing to the Amendment",246,172,13,0,431
326076,221539,2011-05-26,House,"On Agreeing to the Amendment",165,253,13,0,431
326076,221540,2011-05-26,House,"On Agreeing to the Amendment",246,173,12,0,431
326076,221541,2011-05-26,House,"On Agreeing to the Amendment",91,329,11,0,431
326076,221542,2011-05-26,House,"On Agreeing to the Amendment",227,193,11,0,431
326076,221543,2011-05-26,House,"On Agreeing to the Amendment",172,246,13,0,431
326076,221544,2011-05-26,House,"On Agreeing to the Amendment",187,234,10,0,431
326076,221545,2011-05-26,House,"On Agreeing to the Amendment",63,354,14,0,431
326076,221546,2011-05-26,House,"On Agreeing to the Amendment",98,321,12,0,431
326076,221547,2011-05-26,House,"On Agreeing to the Amendment",123,294,14,0,431
326076,221548,2011-05-26,House,"On Agreeing to the Amendment",96,323,12,0,431
326076,221549,2011-05-26,House,"On Agreeing to the Amendment",416,5,10,0,431
326076,221550,2011-05-26,House,"On Agreeing to the Amendment",269,151,11,0,431
326076,221551,2011-05-26,House,"On Agreeing to the Amendment",176,241,14,0,431
326076,221552,2011-05-26,House,"On Agreeing to the Amendment",184,234,13,0,431
326076,221553,2011-05-26,House,"On Agreeing to the Amendment",419,0,12,0,431
326076,221554,2011-05-26,House,"On Agreeing to the Amendment",300,120,11,0,431
326076,221555,2011-05-26,House,"On Agreeing to the Amendment",226,194,11,0,431
326076,221556,2011-05-26,House,"On Agreeing to the Amendment",204,215,12,0,431
326076,221557,2011-05-26,House,"On Motion to Recommit with Instructions",185,233,13,0,431
326076,221558,2011-05-26,House,"On Passage",322,96,13,0,431
326076,221559,2011-12-07,House,"On Motion to Instruct Conferees",421,2,10,0,433
326076,221560,2011-12-07,House,"On Motion to Close Portions of Conference",406,17,10,0,433
326076,221561,2011-12-14,House,"On Motion to Recommit with Instructions",183,234,16,0,433
326076,221562,2011-12-14,House,"On Agreeing to the Conference Report",283,136,14,0,433
327307,218832,2011-05-03,House,"On Ordering the Previous Question",234,185,13,0,432
327307,218833,2011-05-03,House,"On Agreeing to the Resolution",237,185,10,0,432
327368,219310,2011-05-04,House,"On Agreeing to the Resolution",243,177,12,0,432
328343,220130,2011-05-05,House,"On Ordering the Previous Question",241,171,20,0,432
328343,220131,2011-05-05,House,"On Agreeing to the Resolution",245,167,20,0,432
328604,216829,2011-05-03,Senate,"On the Resolution S.Res. 159",97,0,3,0,100
329221,217032,2012-02-07,House,"On Agreeing to the Amendment",191,230,11,0,432
329221,217033,2012-02-07,House,"On Motion to Recommit with Instructions",186,238,9,0,433
329221,217034,2012-02-07,House,"On Passage",259,164,10,0,433
329221,219405,2012-02-07,House,"On Agreeing to the Amendment",191,230,11,0,432
329221,219406,2012-02-07,House,"On Motion to Recommit with Instructions",186,238,9,0,433
329221,219407,2012-02-07,House,"On Passage",259,164,10,0,433
329492,219878,2011-11-29,House,"On Motion to Suspend the Rules and Pass, as Amended",404,0,29,0,433
329508,219435,2011-05-11,House,"On Ordering the Previous Question",241,179,11,0,431
329508,219436,2011-05-11,House,"On Agreeing to the Resolution",243,179,9,0,431
329523,216218,2012-09-13,House,"On Motion to Suspend the Rules and Pass, as Amended",410,3,16,0,429
329523,219939,2012-09-13,House,"On Motion to Suspend the Rules and Pass, as Amended",410,3,16,0,429
329838,219625,2011-05-12,House,"On Agreeing to the Resolution",251,133,47,0,431
330100,216861,2011-05-17,Senate,"On the Motion to Proceed S. 940",52,48,0,0,100
330109,216757,2012-04-17,House,"On Motion to Suspend the Rules and Pass",410,2,19,0,431
330109,221385,2012-04-17,House,"On Motion to Suspend the Rules and Pass",410,2,19,0,431
330117,216971,2012-12-20,House,"On Motion to Suspend the Rules and Pass",408,7,16,0,431
330117,219124,2012-12-20,House,"On Motion to Suspend the Rules and Pass",408,7,16,0,431
330164,220273,2011-05-12,House,"On Agreeing to the Resolution",227,158,46,0,431
330263,219546,2011-07-07,House,"On Motion to Suspend the Rules and Agree",407,6,18,0,431
330273,219543,2011-07-30,House,"On Motion to Suspend the Rules and Pass",414,3,15,0,432
330287,216032,2011-05-18,Senate,"On the Motion to Proceed S. 953",42,57,1,0,100
330599,216427,2012-12-19,House,"On Motion to Suspend the Rules and Pass, as Amended",401,3,27,0,431
330599,220571,2012-12-19,House,"On Motion to Suspend the Rules and Pass, as Amended",401,3,27,0,431
330796,216461,2011-05-26,Senate,"On the Cloture Motion S. 990",79,18,3,0,100
330796,216462,2011-05-26,Senate,"On the Motion to Table S.Amdt. 363 to S.Amdt. 347 to S. 990 (PATRIOT Sunsets Extension Act of 2011)",85,10,5,0,100
330796,216463,2011-05-26,Senate,"On the Motion to Table S.Amdt. 365 to S.Amdt. 347 to S. 990 (PATRIOT Sunsets Extension Act of 2011)",91,4,5,0,100
330796,216464,2011-05-26,Senate,"On the Motion (Motion to Concur in the House Amendment to S. 990 with Amdt. No. 347)",72,23,5,0,100
330796,216465,2011-05-26,Senate,"On the Motion (Motion to Concur in the House Amendment to S. 990 with Amdt. No. 347)",72,23,5,0,100
330796,222105,2011-05-26,House,"On Motion to Concur in the Senate Amendment to the House Amendment",250,153,28,0,431
330801,216136,2012-02-29,House,"On Agreeing to the Amendment",178,239,16,0,433
330801,216137,2012-02-29,House,"On Agreeing to the Amendment",178,242,13,0,433
330801,216138,2012-02-29,House,"On Agreeing to the Amendment",177,243,13,0,433
330801,216139,2012-02-29,House,"On Agreeing to the Amendment",181,243,9,0,433
330801,216140,2012-02-29,House,"On Agreeing to the Amendment",174,250,9,0,433
330801,216141,2012-02-29,House,"On Agreeing to the Amendment",178,247,8,0,433
330801,216142,2012-02-29,House,"On Agreeing to the Amendment",180,244,9,0,433
330801,216143,2012-02-29,House,"On Motion to Recommit with Instructions",178,248,7,0,433
330801,216144,2012-02-29,House,"On Passage",246,175,12,0,433
330801,219751,2012-02-29,House,"On Agreeing to the Amendment",178,239,16,0,433
330801,219752,2012-02-29,House,"On Agreeing to the Amendment",178,242,13,0,433
330801,219753,2012-02-29,House,"On Agreeing to the Amendment",177,243,13,0,433
330801,219754,2012-02-29,House,"On Agreeing to the Amendment",181,243,9,0,433
330801,219755,2012-02-29,House,"On Agreeing to the Amendment",174,250,9,0,433
330801,219756,2012-02-29,House,"On Agreeing to the Amendment",178,247,8,0,433
330801,219757,2012-02-29,House,"On Agreeing to the Amendment",180,244,9,0,433
330801,219758,2012-02-29,House,"On Motion to Recommit with Instructions",178,248,7,0,433
330801,219759,2012-02-29,House,"On Passage",246,175,12,0,433
331477,216817,2011-05-23,Senate,"On Cloture on the Motion to Proceed S. 1038",74,8,18,0,100
331477,216818,2011-05-24,Senate,"On the Motion to Table S. 1038",74,13,13,0,100
331480,216935,2011-05-19,Senate,"On the Motion to Proceed S.Con.Res. 20",7,90,3,0,100
331485,216999,2011-05-19,Senate,"On the Motion to Proceed S.Con.Res. 18",0,97,3,0,100
331929,218827,2011-05-24,House,"On Ordering the Previous Question",233,179,19,0,431
331929,218828,2011-05-24,House,"On Agreeing to the Resolution",238,181,12,0,431
332611,219944,2011-09-09,House,"On Agreeing to the Amendment",397,0,34,0,431
332611,219945,2011-09-09,House,"On Agreeing to the Amendment",303,92,36,0,431
332611,219946,2011-09-09,House,"On Motion to Recommit with Instructions",145,257,29,0,431
332611,219947,2011-09-09,House,"On Passage",384,14,33,0,431
332611,219948,2011-12-16,House,"On Motion to Suspend the Rules and Concur in the Senate Amendment",396,23,14,0,433
332647,220147,2011-06-03,House,"On Agreeing to the Resolution",148,265,19,0,432
332715,219157,2011-05-25,House,"On Ordering the Previous Question",239,181,11,0,431
332715,219158,2011-05-25,House,"On Agreeing to the Resolution",243,170,18,0,431
332793,218732,2011-05-31,House,"On Motion to Suspend the Rules and Pass",97,318,16,0,431
332876,216931,2011-05-23,Senate,"On the Motion to Proceed S.Con.Res. 21",42,55,3,0,100
333317,218685,2011-07-26,House,"On Agreeing to the Amendment",164,260,8,0,432
333317,218686,2011-07-26,House,"On Agreeing to the Amendment",164,261,7,0,432
333317,218687,2011-07-26,House,"On Agreeing to the Amendment",163,264,5,0,432
333317,218688,2011-07-26,House,"On Agreeing to the Amendment",155,272,5,0,432
333317,218689,2011-07-26,House,"On Agreeing to the Amendment",152,275,5,0,432
333317,218690,2011-07-26,House,"On Agreeing to the Amendment",161,265,6,0,432
333317,218691,2011-07-26,House,"On Agreeing to the Amendment",168,260,4,0,432
333317,218692,2011-07-26,House,"On Agreeing to the Amendment",163,263,6,0,432
333317,218693,2011-07-26,House,"On Agreeing to the Amendment",164,261,7,0,432
333317,218694,2011-07-26,House,"On Motion to Recommit with Instructions",181,248,3,0,432
333317,218695,2011-07-26,House,"On Passage",279,147,6,0,432
333318,220512,2011-08-01,House,"On Motion to Suspend the Rules and Pass, as Amended",407,17,8,0,432
333358,219398,2011-10-26,House,"On Agreeing to the Amendment",189,233,11,0,433
333358,219399,2011-10-26,House,"On Agreeing to the Amendment",173,238,22,0,433
333358,219400,2011-10-26,House,"On Agreeing to the Amendment",182,240,11,0,433
333358,219401,2011-10-26,House,"On Motion to Recommit with Instructions",187,237,9,0,433
333358,219402,2011-10-26,House,"On Passage",235,186,12,0,433
333561,220031,2011-12-14,House,"On Motion to Suspend the Rules and Pass, as Amended",410,11,12,0,433
333566,220655,2011-05-31,House,"On Motion to Suspend the Rules and Pass",387,33,11,0,431
333622,216043,2011-09-12,Senate,"On the Cloture Motion H.J.Res. 66",53,33,14,0,100
333622,216044,2011-09-12,Senate,"On the Cloture Motion H.J.Res. 66",53,33,14,0,100
333622,216045,2011-09-13,Senate,"On the Cloture Motion H.J.Res. 66",53,33,14,0,100
333622,216046,2011-09-15,Senate,"On the Amendment S.Amdt. 610 to S.Amdt. 602 to H.J.Res. 66 (No short title on file)",54,45,1,0,100
333622,216047,2011-09-15,Senate,"On the Amendment S.Amdt. 613 to S.Amdt. 602 to H.J.Res. 66 (No short title on file)",20,78,2,0,100
333622,217058,2011-09-13,Senate,"On Cloture on the Motion to Proceed H.J.Res. 66",61,38,1,0,100
333622,217059,2011-09-15,Senate,"On the Amendment S.Amdt. 602 to H.J.Res. 66 (No short title on file)",62,37,1,0,100
333641,219511,2011-06-01,House,"On Agreeing to the Amendment",333,87,12,0,432
333641,219512,2011-06-01,House,"On Agreeing to the Amendment",154,266,12,0,432
333641,219513,2011-06-01,House,"On Agreeing to the Amendment",268,151,13,0,432
333641,219514,2011-06-01,House,"On Agreeing to the Amendment",327,93,12,0,432
333641,219515,2011-06-01,House,"On Agreeing to the Amendment",162,256,14,0,432
333641,219516,2011-06-02,House,"On Agreeing to the Amendment",273,150,9,0,432
333641,219517,2011-06-02,House,"On Agreeing to the Amendment",218,204,10,0,432
333641,219518,2011-06-02,House,"On Agreeing to the Amendment",238,177,17,0,432
333641,219519,2011-06-02,House,"On Agreeing to the Amendment",242,180,10,0,432
333641,219520,2011-06-02,House,"On Agreeing to the Amendment",264,157,11,0,432
333641,219521,2011-06-02,House,"On Agreeing to the Amendment",208,213,11,0,432
333641,219522,2011-06-02,House,"On Agreeing to the Amendment",183,234,15,0,432
333641,219523,2011-06-02,House,"On Agreeing to the Amendment",207,213,12,0,432
333641,219524,2011-06-02,House,"On Agreeing to the Amendment",251,168,13,0,432
333641,219525,2011-06-02,House,"On Agreeing to the Amendment",289,131,12,0,432
333641,219526,2011-06-02,House,"On Agreeing to the Amendment",127,295,10,0,432
333641,219527,2011-06-02,House,"On Agreeing to the Amendment",123,300,9,0,432
333641,219528,2011-06-02,House,"On Agreeing to the Amendment",257,164,11,0,432
333641,219529,2011-06-02,House,"On Agreeing to the Amendment",110,312,10,0,432
333641,219530,2011-06-02,House,"On Agreeing to the Amendment",218,205,9,0,432
333641,219531,2011-06-02,House,"On Agreeing to the Amendment",252,170,10,0,432
333641,219532,2011-06-02,House,"On Agreeing to the Amendment",199,224,9,0,432
333641,219533,2011-06-02,House,"On Agreeing to the Amendment",219,204,9,0,432
333641,219534,2011-06-02,House,"On Agreeing to the Amendment",107,313,12,0,432
333641,219535,2011-06-02,House,"On Motion to Recommit with Instructions",187,234,11,0,432
333641,219536,2011-06-02,House,"On Passage",231,188,13,0,432
333837,221003,2011-11-02,House,"On Motion to Suspend the Rules and Pass, as Amended",420,2,11,0,433
334307,216311,2011-07-11,Senate,"On Cloture on the Motion to Proceed H.R. 2055",89,11,0,0,100
334307,216312,2011-07-14,Senate,"On the Cloture Motion H.R. 2055",71,26,3,0,100
334307,216313,2011-07-14,Senate,"On the Motion (Motion to Waive Section 303 of the Congressional Budget Act on H.R. 2055, any amendments thereto and motions thereon)",56,40,4,0,100
334307,216314,2011-07-20,Senate,"On the Motion to Table S.Amdt. 568 to H.R. 2055 (Military Construction and Veterans Affairs and Related Agencies Appropriations Act, 2012)",69,30,1,0,100
334307,216315,2011-07-20,Senate,"On the Motion to Table S.Amdt. 564 to H.R. 2055 (Military Construction and Veterans Affairs and Related Agencies Appropriations Act, 2012)",69,30,1,0,100
334307,216316,2011-07-20,Senate,"On Passage of the Bill H.R. 2055",97,2,1,0,100
334307,216317,2011-12-17,Senate,"On the Conference Report H.R. 2055",67,32,1,0,100
334307,216318,2011-12-17,Senate,"On the Conference Report H.R. 2055",67,32,1,0,100
334307,220286,2011-06-13,House,"On Agreeing to the Amendment",204,203,25,0,432
334307,220287,2011-06-13,House,"On Agreeing to the Amendment",178,232,22,0,432
334307,220288,2011-06-13,House,"On Agreeing to the Amendment",248,163,21,0,432
334307,220289,2011-06-13,House,"On Retaining Title II (Department of Veterans Affairs)",409,1,22,0,432
334307,220290,2011-06-14,House,"On Motion to Recommit with Instructions",184,234,14,0,432
334307,220291,2011-06-14,House,"On Passage",411,5,16,0,432
334307,220292,2011-12-07,House,"On Motion to Instruct Conferees",409,13,11,0,433
334307,220293,2011-12-16,House,"On Agreeing to the Conference Report",296,121,16,0,433
334334,219121,2011-06-01,House,"On Consideration of the Resolution",234,183,14,0,431
334334,219122,2011-06-01,House,"On Ordering the Previous Question",235,186,10,0,431
334334,219123,2011-06-01,House,"On Agreeing to the Resolution",231,187,14,0,432
334340,219544,2011-07-30,House,"On Motion to Suspend the Rules and Pass",416,0,16,0,432
334509,219165,2011-07-13,House,"On Agreeing to the Amendment",170,252,9,0,431
334509,219166,2011-07-13,House,"On Agreeing to the Amendment",268,152,11,0,431
334509,219167,2011-07-13,House,"On Agreeing to the Amendment",191,231,9,0,431
334509,219168,2011-07-13,House,"On Agreeing to the Amendment",181,240,10,0,431
334509,219169,2011-07-13,House,"On Agreeing to the Amendment",183,237,11,0,431
334509,219170,2011-07-13,House,"On Agreeing to the Amendment",173,247,11,0,431
334509,219171,2011-07-13,House,"On Agreeing to the Amendment",167,254,10,0,431
334509,219172,2011-07-13,House,"On Motion to Recommit with Instructions",188,238,5,0,431
334509,219173,2011-07-13,House,"On Passage",239,184,8,0,431
334559,218715,2011-06-22,House,"On Agreeing to the Amendment",176,248,7,0,431
334559,218716,2011-06-22,House,"On Agreeing to the Amendment",167,254,10,0,431
334559,218717,2011-06-22,House,"On Agreeing to the Amendment",183,238,10,0,431
334559,218718,2011-06-22,House,"On Agreeing to the Amendment",167,258,6,0,431
334559,218719,2011-06-22,House,"On Agreeing to the Amendment",172,253,6,0,431
334559,218720,2011-06-22,House,"On Agreeing to the Amendment",173,251,7,0,431
334559,218721,2011-06-22,House,"On Agreeing to the Amendment",183,240,8,0,431
334559,218722,2011-06-22,House,"On Agreeing to the Amendment",180,242,9,0,431
334559,218723,2011-06-22,House,"On Agreeing to the Amendment",186,238,7,0,431
334559,218724,2011-06-22,House,"On Agreeing to the Amendment",160,262,9,0,431
334559,218725,2011-06-22,House,"On Motion to Recommit with Instructions",177,245,9,0,431
334559,218726,2011-06-22,House,"On Passage",253,166,12,0,431
334956,219831,2011-06-03,House,"On Agreeing to the Resolution",257,156,19,0,432
334985,219691,2011-06-03,House,"On Agreeing to the Resolution",268,145,19,0,432
334994,219561,2011-11-02,House,"On Motion to Suspend the Rules and Pass, as Amended",425,0,8,0,433
335025,216146,2011-10-18,Senate,"On the Amendment S.Amdt. 775 to S.Amdt. 738 to H.R. 2112 (Agriculture, Rural Development, Food and Drug Administration, and Related Agencies Appropriations Act, 2012)",99,0,1,0,100
335025,216147,2011-10-18,Senate,"On the Amendment S.Amdt. 740 to S.Amdt. 738 to H.R. 2112 (Agriculture, Rural Development, Food and Drug Administration, and Related Agencies Appropriations Act, 2012)",44,55,1,0,100
335025,216148,2011-10-19,Senate,"On the Motion to Table S.Amdt. 739 to S.Amdt. 738 to H.R. 2112 (Agriculture, Rural Development, Food and Drug Administration, and Related Agencies Appropriations Act, 2012)",59,39,2,0,100
335025,216149,2011-10-20,Senate,"On the Amendment S.Amdt. 769 to S.Amdt. 738 to H.R. 2112 (Agriculture, Rural Development, Food and Drug Administration, and Related Agencies Appropriations Act, 2012)",45,55,0,0,100
335025,216150,2011-10-20,Senate,"On the Amendment S.Amdt. 750 to S.Amdt. 738 to H.R. 2112 (Agriculture, Rural Development, Food and Drug Administration, and Related Agencies Appropriations Act, 2012)",57,43,0,0,100
335025,216151,2011-10-20,Senate,"On the Amendment S.Amdt. 879 to S.Amdt. 738 to H.R. 2112 (Agriculture, Rural Development, Food and Drug Administration, and Related Agencies Appropriations Act, 2012)",55,44,1,0,100
335025,216152,2011-10-20,Senate,"On the Amendment S.Amdt. 860 to S.Amdt. 738 to H.R. 2112 (Agriculture, Rural Development, Food and Drug Administration, and Related Agencies Appropriations Act, 2012)",46,54,0,0,100
335025,216153,2011-10-20,Senate,"On the Amendment S.Amdt. 917 to S.Amdt. 857 to S.Amdt. 738 to H.R. 2112",41,57,2,0,100
335025,216154,2011-10-20,Senate,"On the Amendment S.Amdt. 857 to S.Amdt. 738 to H.R. 2112 (Agriculture, Rural Development, Food and Drug Administration, and Related Agencies Appropriations Act, 2012)",60,38,2,0,100
335025,216155,2011-10-20,Senate,"On the Amendment S.Amdt. 869 to S.Amdt. 738 to H.R. 2112 (Agriculture, Rural Development, Food and Drug Administration, and Related Agencies Appropriations Act, 2012)",58,41,1,0,100
335025,216156,2011-10-21,Senate,"On the Amendment S.Amdt. 810 to S.Amdt. 738 to H.R. 2112 (Agriculture, Rural Development, Food and Drug Administration, and Related Agencies Appropriations Act, 2012)",41,58,1,0,100
335025,216157,2011-10-21,Senate,"On the Amendment S.Amdt. 791 to S.Amdt. 738 to H.R. 2112 (Agriculture, Rural Development, Food and Drug Administration, and Related Agencies Appropriations Act, 2012)",84,15,1,0,100
335025,216158,2011-10-21,Senate,"On the Amendment S.Amdt. 792 to S.Amdt. 738 to H.R. 2112 (Agriculture, Rural Development, Food and Drug Administration, and Related Agencies Appropriations Act, 2012)",59,40,1,0,100
335025,216159,2011-10-21,Senate,"On the Amendment S.Amdt. 796 to S.Amdt. 738 to H.R. 2112 (Agriculture, Rural Development, Food and Drug Administration, and Related Agencies Appropriations Act, 2012)",73,26,1,0,100
335025,216160,2011-10-21,Senate,"On the Amendment S.Amdt. 753 to S.Amdt. 738 to H.R. 2112 (Agriculture, Rural Development, Food and Drug Administration, and Related Agencies Appropriations Act, 2012)",47,52,1,0,100
335025,216161,2011-10-21,Senate,"On the Cloture Motion S.Amdt. 738 to H.R. 2112 (Agriculture, Rural Development, Food and Drug Administration, and Related Agencies Appropriations Act, 2012)",82,16,2,0,100
335025,216162,2011-11-01,Senate,"On the Amendment S.Amdt. 800 to S.Amdt. 738 to H.R. 2112 (Agriculture, Rural Development, Food and Drug Administration, and Related Agencies Appropriations Act, 2012)",13,85,2,0,100
335025,216163,2011-11-01,Senate,"On the Amendment S.Amdt. 821 to H.R. 2112 (Agriculture, Rural Development, Food and Drug Administration, and Related Agencies Appropriations Act, 2012)",38,60,2,0,100
335025,216164,2011-11-01,Senate,"On the Amendment S.Amdt. 763 to S.Amdt. 738 to H.R. 2112 (Agriculture, Rural Development, Food and Drug Administration, and Related Agencies Appropriations Act, 2012)",44,54,2,0,100
335025,216165,2011-11-01,Senate,"On the Amendment S.Amdt. 801 to S.Amdt. 738 to H.R. 2112 (Agriculture, Rural Development, Food and Drug Administration, and Related Agencies Appropriations Act, 2012)",41,57,2,0,100
335025,216166,2011-11-01,Senate,"On the Motion to Recommit H.R. 2112",39,60,1,0,100
335025,216167,2011-11-01,Senate,"On Passage of the Bill H.R. 2112",69,30,1,0,100
335025,216168,2011-11-17,Senate,"On the Conference Report H.R. 2112",70,30,0,0,100
335025,219704,2011-06-15,House,"On Agreeing to the Amendment",193,226,13,0,432
335025,219705,2011-06-15,House,"On Agreeing to the Amendment",226,199,7,0,432
335025,219706,2011-06-15,House,"On Agreeing to the Amendment",352,70,10,0,432
335025,219707,2011-06-15,House,"On Agreeing to the Amendment",120,304,8,0,432
335025,219708,2011-06-15,House,"On Agreeing to the Amendment",83,338,11,0,432
335025,219709,2011-06-15,House,"On Agreeing to the Amendment",125,298,9,0,432
335025,219710,2011-06-15,House,"On Agreeing to the Amendment",142,282,8,0,432
335025,219711,2011-06-15,House,"On Agreeing to the Amendment",107,318,7,0,432
335025,219712,2011-06-15,House,"On Agreeing to the Amendment",200,224,8,0,432
335025,219713,2011-06-15,House,"On Agreeing to the Amendment",139,285,8,0,432
335025,219714,2011-06-15,House,"On Agreeing to the Amendment",64,360,8,0,432
335025,219715,2011-06-15,House,"On Agreeing to the Amendment",119,306,7,0,432
335025,219716,2011-06-15,House,"On Agreeing to the Amendment",99,324,9,0,432
335025,219717,2011-06-15,House,"On Agreeing to the Amendment",124,300,8,0,432
335025,219718,2011-06-15,House,"On Agreeing to the Amendment",108,316,8,0,432
335025,219719,2011-06-15,House,"On Agreeing to the Amendment",120,303,9,0,432
335025,219720,2011-06-15,House,"On Agreeing to the Amendment",164,257,11,0,432
335025,219721,2011-06-16,House,"On Agreeing to the Amendment",170,238,24,0,432
335025,219722,2011-06-16,House,"On Agreeing to the Amendment",212,201,19,0,432
335025,219723,2011-06-16,House,"On Agreeing to the Amendment",223,197,12,0,432
335025,219724,2011-06-16,House,"On Agreeing to the Amendment",178,241,13,0,432
335025,219725,2011-06-16,House,"On Agreeing to the Amendment",167,252,13,0,432
335025,219726,2011-06-16,House,"On Agreeing to the Amendment",221,198,13,0,432
335025,219727,2011-06-16,House,"On Agreeing to the Amendment",154,262,16,0,432
335025,219728,2011-06-16,House,"On Agreeing to the Amendment",155,262,15,0,432
335025,219729,2011-06-16,House,"On Agreeing to the Amendment",240,176,16,0,432
335025,219730,2011-06-16,House,"On Agreeing to the Amendment",231,189,12,0,432
335025,219731,2011-06-16,House,"On Agreeing to the Amendment",181,237,14,0,432
335025,219732,2011-06-16,House,"On Agreeing to the Amendment",238,179,15,0,432
335025,219733,2011-06-16,House,"On Agreeing to the Amendment",182,235,15,0,432
335025,219734,2011-06-16,House,"On Agreeing to the Amendment",288,132,12,0,432
335025,219735,2011-06-16,House,"On Agreeing to the Amendment",84,335,13,0,432
335025,219736,2011-06-16,House,"On Agreeing to the Amendment",132,287,13,0,432
335025,219737,2011-06-16,House,"On Agreeing to the Amendment",109,310,13,0,432
335025,219738,2011-06-16,House,"On Agreeing to the Amendment",283,128,21,0,432
335025,219739,2011-06-16,House,"On Agreeing to the Amendment",186,228,18,0,432
335025,219740,2011-06-16,House,"On Agreeing to the Amendment",162,254,16,0,432
335025,219741,2011-06-16,House,"On Agreeing to the Amendment",101,314,17,0,432
335025,219742,2011-06-16,House,"On Motion to Recommit with Instructions",185,233,14,0,432
335025,219743,2011-06-16,House,"On Passage",217,203,12,0,432
335025,219744,2011-11-03,House,"On Motion to Instruct Conferees",265,160,8,0,433
335025,219745,2011-11-17,House,"On Agreeing to the Conference Report",298,121,14,0,433
335140,216760,2012-01-24,House,"On Motion to Suspend the Rules and Pass, as Amended",386,26,21,0,433
335140,221400,2012-01-24,House,"On Motion to Suspend the Rules and Pass, as Amended",386,26,21,0,433
335143,219551,2011-09-12,House,"On Motion to Suspend the Rules and Pass, as Amended",358,9,64,0,431
335152,216211,2012-05-09,House,"On Motion to Suspend the Rules and Pass, as Amended",330,93,8,0,431
335152,216212,2012-05-15,Senate,"On the Amendment S.Amdt. 2100 to H.R. 2072 (Export-Import Bank Reauthorization Act of 2012)",12,86,2,0,100
335152,216213,2012-05-15,Senate,"On the Amendment S.Amdt. 2101 to H.R. 2072 (Export-Import Bank Reauthorization Act of 2012)",9,89,2,0,100
335152,216214,2012-05-15,Senate,"On the Amendment S.Amdt. 2102 to H.R. 2072 (Export-Import Bank Reauthorization Act of 2012)",36,62,2,0,100
335152,216215,2012-05-15,Senate,"On the Amendment S.Amdt. 2103 to H.R. 2072 (Export-Import Bank Reauthorization Act of 2012)",37,61,2,0,100
335152,216216,2012-05-15,Senate,"On the Amendment S.Amdt. 2104 to H.R. 2072 (Export-Import Bank Reauthorization Act of 2012)",35,63,2,0,100
335152,216217,2012-05-15,Senate,"On Passage of the Bill H.R. 2072",78,20,2,0,100
335152,219943,2012-05-09,House,"On Motion to Suspend the Rules and Pass, as Amended",330,93,8,0,431
335159,216329,2012-02-15,House,"On Motion to Suspend the Rules and Pass",418,2,13,0,433
335159,220333,2012-02-15,House,"On Motion to Suspend the Rules and Pass",418,2,13,0,433
335259,216428,2012-03-20,House,"On Agreeing to the Amendment",178,226,27,0,431
335259,216429,2012-03-20,House,"On Motion to Recommit with Instructions",180,226,25,0,431
335259,216430,2012-03-20,House,"On Passage",240,164,27,0,431
335259,220587,2012-03-20,House,"On Agreeing to the Amendment",178,226,27,0,431
335259,220588,2012-03-20,House,"On Motion to Recommit with Instructions",180,226,25,0,431
335259,220589,2012-03-20,House,"On Passage",240,164,27,0,431
335305,217022,2012-04-27,House,"On Motion to Suspend the Rules and Pass, as Amended",395,10,26,0,431
335305,219352,2012-04-27,House,"On Motion to Suspend the Rules and Pass, as Amended",395,10,26,0,431
335416,218760,2011-12-14,House,"On Motion to Suspend the Rules and Pass, as Amended",418,2,13,0,433
335426,216714,2012-02-28,House,"On Agreeing to the Amendment",170,247,16,0,433
335426,216715,2012-02-28,House,"On Agreeing to the Amendment",160,255,18,0,433
335426,216716,2012-02-28,House,"On Agreeing to the Amendment",199,217,17,0,433
335426,216717,2012-02-28,House,"On Motion to Recommit with Instructions",176,241,16,0,433
335426,216718,2012-02-28,House,"On Passage",303,114,16,0,433
335426,221243,2012-02-28,House,"On Agreeing to the Amendment",170,247,16,0,433
335426,221244,2012-02-28,House,"On Agreeing to the Amendment",160,255,18,0,433
335426,221245,2012-02-28,House,"On Agreeing to the Amendment",199,217,17,0,433
335426,221246,2012-02-28,House,"On Motion to Recommit with Instructions",176,241,16,0,433
335426,221247,2012-02-28,House,"On Passage",303,114,16,0,433
335635,216557,2012-09-10,House,"On Motion to Suspend the Rules and Pass, as Amended",376,2,51,0,429
335635,220989,2012-09-10,House,"On Motion to Suspend the Rules and Pass, as Amended",376,2,51,0,429
335724,216250,2012-03-01,House,"On Motion to Suspend the Rules and Pass",339,80,14,0,433
335724,220041,2012-03-01,House,"On Motion to Suspend the Rules and Pass",339,80,14,0,433
335747,216789,2012-04-24,House,"On Motion to Suspend the Rules and Pass",376,2,53,0,431
335747,221621,2012-04-24,House,"On Motion to Suspend the Rules and Pass",376,2,53,0,431
335771,220472,2011-12-12,House,"On Motion to Suspend the Rules and Pass",353,1,79,0,433
335777,218919,2011-06-14,House,"On Agreeing to the Resolution",235,180,17,0,432
336284,219461,2011-07-06,House,"On Agreeing to the Amendment",175,241,15,0,431
336284,219462,2011-07-06,House,"On Agreeing to the Amendment",87,328,16,0,431
336284,219463,2011-07-06,House,"On Agreeing to the Amendment",152,266,13,0,431
336284,219464,2011-07-06,House,"On Agreeing to the Amendment",253,167,11,0,431
336284,219465,2011-07-06,House,"On Agreeing to the Amendment",98,322,11,0,431
336284,219466,2011-07-06,House,"On Agreeing to the Amendment",212,208,11,0,431
336284,219467,2011-07-06,House,"On Agreeing to the Amendment",217,204,10,0,431
336284,219468,2011-07-07,House,"On Agreeing to the Amendment",97,322,12,0,431
336284,219469,2011-07-07,House,"On Agreeing to the Amendment",133,295,3,0,431
336284,219470,2011-07-07,House,"On Agreeing to the Amendment",174,251,6,0,431
336284,219471,2011-07-07,House,"On Agreeing to the Amendment",131,297,3,0,431
336284,219472,2011-07-07,House,"On Agreeing to the Amendment",114,314,3,0,431
336284,219473,2011-07-07,House,"On Agreeing to the Amendment",210,217,4,0,431
336284,219474,2011-07-07,House,"On Agreeing to the Amendment",145,283,3,0,431
336284,219475,2011-07-07,House,"On Agreeing to the Amendment",119,306,6,0,431
336284,219476,2011-07-07,House,"On Agreeing to the Amendment",140,285,6,0,431
336284,219477,2011-07-07,House,"On Agreeing to the Amendment",226,201,4,0,431
336284,219478,2011-07-07,House,"On Agreeing to the Amendment",167,260,4,0,431
336284,219479,2011-07-07,House,"On Agreeing to the Amendment",225,201,5,0,431
336284,219480,2011-07-07,House,"On Agreeing to the Amendment",199,229,3,0,431
336284,219481,2011-07-07,House,"On Agreeing to the Amendment",176,249,6,0,431
336284,219482,2011-07-07,House,"On Agreeing to the Amendment",248,175,8,0,431
336284,219483,2011-07-07,House,"On Agreeing to the Amendment",135,290,6,0,431
336284,219484,2011-07-07,House,"On Agreeing to the Amendment",316,111,4,0,431
336284,219485,2011-07-07,House,"On Agreeing to the Amendment",89,338,4,0,431
336284,219486,2011-07-07,House,"On Agreeing to the Amendment",162,265,4,0,431
336284,219487,2011-07-07,House,"On Agreeing to the Amendment",169,257,5,0,431
336284,219488,2011-07-07,House,"On Agreeing to the Amendment",256,170,5,0,431
336284,219489,2011-07-07,House,"On Agreeing to the Amendment",181,244,6,0,431
336284,219490,2011-07-08,House,"On Agreeing to the Amendment",39,380,12,0,431
336284,219491,2011-07-08,House,"On Agreeing to the Amendment",118,295,18,0,431
336284,219492,2011-07-08,House,"On Agreeing to the Amendment",100,321,10,0,431
336284,219493,2011-07-08,House,"On Agreeing to the Amendment",236,184,11,0,431
336284,219494,2011-07-08,House,"On Agreeing to the Amendment",113,307,11,0,431
336284,219495,2011-07-08,House,"On Agreeing to the Amendment",169,251,11,0,431
336284,219496,2011-07-08,House,"On Motion to Recommit with Instructions",188,234,9,0,431
336284,219497,2011-07-08,House,"On Passage",336,87,8,0,431
336343,219416,2011-11-29,House,"On Motion to Suspend the Rules and Pass",407,1,25,0,433
336429,218700,2011-09-13,House,"On Agreeing to the Amendment",195,220,16,0,431
336429,218701,2011-09-13,House,"On Agreeing to the Amendment",43,374,14,0,431
336429,218702,2011-09-13,House,"On Motion to Recommit with Instructions",189,231,11,0,431
336429,218703,2011-09-13,House,"On Passage",365,54,12,0,431
336440,220212,2011-07-29,House,"On Motion to Suspend the Rules and Pass",420,0,12,0,432
336457,219397,2011-09-20,House,"On Motion to Suspend the Rules and Pass",398,18,17,0,433
336680,219324,2011-06-22,House,"On Question of Consideration of the Resolution",215,189,27,0,431
336680,219325,2011-06-22,House,"On Ordering the Previous Question",230,184,17,0,431
336680,219326,2011-06-22,House,"On Agreeing to the Resolution",239,186,6,0,431
337145,219801,2011-06-23,House,"On Ordering the Previous Question",247,168,16,0,431
337145,219802,2011-06-23,House,"On Agreeing to the Resolution",251,173,7,0,431
337149,219914,2011-06-24,House,"On Passage",123,295,13,0,431
337301,220185,2011-07-29,House,"On Motion to Suspend the Rules and Pass",418,1,13,0,432
337350,221423,2011-10-06,House,"On Agreeing to the Amendment",167,243,23,0,433
337350,221424,2011-10-06,House,"On Agreeing to the Amendment",156,242,35,0,433
337350,221425,2011-10-06,House,"On Agreeing to the Amendment",151,255,27,0,433
337350,221426,2011-10-06,House,"On Agreeing to the Amendment",153,254,26,0,433
337350,221427,2011-10-06,House,"On Agreeing to the Amendment",147,251,35,0,433
337350,221428,2011-10-11,House,"On Agreeing to the Amendment",164,254,15,0,433
337350,221429,2011-10-11,House,"On Agreeing to the Amendment",168,250,15,0,433
337350,221430,2011-10-11,House,"On Agreeing to the Amendment",166,252,15,0,433
337350,221431,2011-10-11,House,"On Agreeing to the Amendment",157,260,16,0,433
337350,221432,2011-10-11,House,"On Agreeing to the Amendment",169,249,15,0,433
337350,221433,2011-10-11,House,"On Agreeing to the Amendment",154,261,18,0,433
337350,221434,2011-10-11,House,"On Agreeing to the Amendment",169,249,15,0,433
337350,221435,2011-10-11,House,"On Agreeing to the Amendment",156,262,15,0,433
337350,221436,2011-10-13,House,"On Agreeing to the Amendment",174,250,9,0,433
337350,221437,2011-10-13,House,"On Motion to Recommit with Instructions",170,246,17,0,433
337350,221438,2011-10-13,House,"On Passage",275,142,16,0,433
337361,220084,2011-06-24,House,"On Passage",180,238,13,0,431
337375,219971,2011-06-24,House,"On Agreeing to the Resolution",240,167,24,0,431
337429,219128,2011-10-14,House,"On Agreeing to the Amendment",171,236,26,0,433
337429,219129,2011-10-14,House,"On Agreeing to the Amendment",173,231,29,0,433
337429,219130,2011-10-14,House,"On Agreeing to the Amendment",185,223,25,0,433
337429,219131,2011-10-14,House,"On Agreeing to the Amendment",164,241,28,0,433
337429,219132,2011-10-14,House,"On Agreeing to the Amendment",174,235,24,0,433
337429,219133,2011-10-14,House,"On Motion to Recommit with Instructions",172,238,23,0,433
337429,219134,2011-10-14,House,"On Passage",267,144,22,0,433
337437,216367,2011-11-10,Senate,"On the Cloture Motion H.R. 2354",81,14,5,0,100
337437,220374,2011-07-11,House,"On Agreeing to the Amendment",162,246,23,0,431
337437,220375,2011-07-11,House,"On Agreeing to the Amendment",216,190,25,0,431
337437,220376,2011-07-11,House,"On Agreeing to the Amendment",241,168,22,0,431
337437,220377,2011-07-11,House,"On Agreeing to the Amendment",218,191,22,0,431
337437,220378,2011-07-11,House,"On Agreeing to the Amendment",96,313,22,0,431
337437,220379,2011-07-12,House,"On Agreeing to the Amendment",224,196,11,0,431
337437,220380,2011-07-12,House,"On Agreeing to the Amendment",170,250,11,0,431
337437,220381,2011-07-12,House,"On Agreeing to the Amendment",154,266,11,0,431
337437,220382,2011-07-12,House,"On Agreeing to the Amendment",164,259,8,0,431
337437,220383,2011-07-12,House,"On Agreeing to the Amendment",173,249,9,0,431
337437,220384,2011-07-12,House,"On Agreeing to the Amendment",179,244,8,0,431
337437,220385,2011-07-12,House,"On Agreeing to the Amendment",131,292,8,0,431
337437,220386,2011-07-12,House,"On Agreeing to the Amendment",123,300,8,0,431
337437,220387,2011-07-12,House,"On Agreeing to the Amendment",127,296,8,0,431
337437,220388,2011-07-12,House,"On Agreeing to the Amendment",149,273,9,0,431
337437,220389,2011-07-12,House,"On Agreeing to the Amendment",149,274,8,0,431
337437,220390,2011-07-12,House,"On Agreeing to the Amendment",196,228,7,0,431
337437,220391,2011-07-12,House,"On Agreeing to the Amendment",119,305,7,0,431
337437,220392,2011-07-12,House,"On Agreeing to the Amendment",167,257,7,0,431
337437,220393,2011-07-12,House,"On Agreeing to the Amendment",145,276,10,0,431
337437,220394,2011-07-14,House,"On Agreeing to the Amendment",168,257,6,0,431
337437,220395,2011-07-14,House,"On Agreeing to the Amendment",261,162,8,0,431
337437,220396,2011-07-14,House,"On Agreeing to the Amendment",164,261,6,0,431
337437,220397,2011-07-14,House,"On Agreeing to the Amendment",136,291,4,0,431
337437,220398,2011-07-14,House,"On Agreeing to the Amendment",99,328,4,0,431
337437,220399,2011-07-14,House,"On Agreeing to the Amendment",214,213,4,0,431
337437,220400,2011-07-14,House,"On Agreeing to the Amendment",114,309,8,0,431
337437,220401,2011-07-14,House,"On Agreeing to the Amendment",297,130,4,0,431
337437,220402,2011-07-14,House,"On Agreeing to the Amendment",187,239,5,0,431
337437,220403,2011-07-15,House,"On Agreeing to the Amendment",249,169,13,0,431
337437,220404,2011-07-15,House,"On Agreeing to the Amendment",158,264,9,0,431
337437,220405,2011-07-15,House,"On Agreeing to the Amendment",183,238,10,0,431
337437,220406,2011-07-15,House,"On Agreeing to the Amendment",212,210,9,0,431
337437,220407,2011-07-15,House,"On Agreeing to the Amendment",81,341,9,0,431
337437,220408,2011-07-15,House,"On Agreeing to the Amendment",152,269,10,0,431
337437,220409,2011-07-15,House,"On Agreeing to the Amendment",68,353,10,0,431
337437,220410,2011-07-15,House,"On Agreeing to the Amendment",271,148,12,0,431
337437,220411,2011-07-15,House,"On Agreeing to the Amendment",69,354,8,0,431
337437,220412,2011-07-15,House,"On Agreeing to the Amendment",90,332,9,0,431
337437,220413,2011-07-15,House,"On Agreeing to the Amendment",227,193,11,0,431
337437,220414,2011-07-15,House,"On Agreeing to the Amendment",129,292,10,0,431
337437,220415,2011-07-15,House,"On Agreeing to the Amendment",150,272,9,0,431
337437,220416,2011-07-15,House,"On Agreeing to the Amendment",236,185,10,0,431
337437,220417,2011-07-15,House,"On Agreeing to the Amendment",68,351,12,0,431
337437,220418,2011-07-15,House,"On Agreeing to the Amendment",181,233,17,0,431
337437,220419,2011-07-15,House,"On Motion to Recommit with Instructions",182,232,17,0,431
337437,220420,2011-07-15,House,"On Passage",219,196,16,0,431
337884,219848,2011-11-01,House,"On Motion to Suspend the Rules and Pass",406,0,27,0,433
338777,216325,2011-07-07,Senate,"On Cloture on the Motion to Proceed S. 1323",74,22,4,0,100
338777,216326,2011-07-11,Senate,"On the Motion to Proceed S. 1323",69,27,4,0,100
338777,216327,2011-07-13,Senate,"On the Cloture Motion S. 1323",51,49,0,0,100
338819,220736,2011-09-23,House,"On Agreeing to the Amendment",173,236,24,0,433
338819,220737,2011-09-23,House,"On Agreeing to the Amendment",184,229,20,0,433
338819,220738,2011-09-23,House,"On Agreeing to the Amendment",337,76,20,0,433
338819,220739,2011-09-23,House,"On Agreeing to the Amendment",195,221,17,0,433
338819,220740,2011-09-23,House,"On Agreeing to the Amendment",269,145,19,0,433
338819,220741,2011-09-23,House,"On Agreeing to the Amendment",269,150,14,0,433
338819,220742,2011-09-23,House,"On Agreeing to the Amendment",165,254,14,0,433
338819,220743,2011-09-23,House,"On Agreeing to the Amendment",186,232,15,0,433
338819,220744,2011-09-23,House,"On Agreeing to the Amendment",346,74,13,0,433
338819,220745,2011-09-23,House,"On Agreeing to the Amendment",234,188,11,0,433
338819,220746,2011-09-23,House,"On Agreeing to the Amendment",227,192,14,0,433
338819,220747,2011-09-23,House,"On Agreeing to the Amendment",181,237,15,0,433
338819,220748,2011-09-23,House,"On Motion to Recommit with Instructions",180,233,20,0,433
338819,220749,2011-09-23,House,"On Passage",249,169,15,0,433
338852,216495,2012-07-23,House,"On Motion to Suspend the Rules and Pass, as Amended",222,160,49,0,431
338852,220766,2012-07-23,House,"On Motion to Suspend the Rules and Pass, as Amended",222,160,49,0,431
338885,218924,2011-07-12,House,"On Motion to Suspend the Rules and Pass",233,193,5,0,431
338913,219641,2011-11-14,House,"On Motion to Suspend the Rules and Pass",390,0,43,0,433
338928,219656,2011-07-08,House,"On Agreeing to the Resolution",269,146,16,0,431
338995,216260,2012-04-18,House,"On Motion to Suspend the Rules and Pass, as Amended",408,4,19,0,431
338995,216261,2012-11-14,House,"On Motion to Suspend the Rules and Concur in the Senate Amendments",370,19,44,0,433
338995,220078,2012-04-18,House,"On Motion to Suspend the Rules and Pass, as Amended",408,4,19,0,431
338995,220079,2012-11-14,House,"On Motion to Suspend the Rules and Concur in the Senate Amendments",370,19,44,0,433
339009,219879,2011-10-25,House,"On Motion to Suspend the Rules and Pass",422,0,11,0,433
339013,219160,2011-10-12,House,"On Motion to Suspend the Rules and Pass, as Amended",418,6,9,0,433
339039,219343,2011-08-01,House,"On Motion to Suspend the Rules and Pass, as Amended",382,23,27,0,432
339048,221017,2011-12-06,House,"On Motion to Suspend the Rules and Pass, as Amended",303,116,14,0,433
339125,218982,2011-07-13,House,"On Agreeing to the Resolution",250,171,10,0,431
339262,220014,2011-10-26,House,"On Motion to Suspend the Rules and Pass, as Amended",416,3,14,0,433
339284,216553,2011-07-22,Senate,"On the Motion to Table H.R. 2560",51,46,3,0,100
339284,220974,2011-07-19,House,"On Motion to Recommit with Instructions",188,236,8,0,432
339284,220975,2011-07-19,House,"On Passage",234,190,8,0,432
339294,219209,2011-07-20,House,"On Motion to Recommit with Instructions",187,233,12,0,432
339294,219210,2011-07-20,House,"On Passage",243,177,12,0,432
339302,219364,2011-07-22,House,"On Agreeing to the Amendment",102,302,28,0,432
339302,219365,2011-07-22,House,"On Agreeing to the Amendment",299,112,21,0,432
339302,219366,2011-07-22,House,"On Agreeing to the Amendment",153,260,19,0,432
339302,219367,2011-07-22,House,"On Agreeing to the Amendment",218,194,20,0,432
339302,219368,2011-07-22,House,"On Agreeing to the Amendment",130,283,19,0,432
339302,219369,2011-07-22,House,"On Agreeing to the Amendment",176,235,21,0,432
339302,219370,2011-07-22,House,"On Agreeing to the Amendment",179,234,19,0,432
339302,219371,2011-07-22,House,"On Passage",252,159,21,0,432
339322,218937,2011-10-27,House,"On Passage",262,157,14,0,433
339326,216112,2012-06-19,House,"On Agreeing to the Amendment",184,236,12,0,432
339326,216113,2012-06-19,House,"On Agreeing to the Amendment",156,268,8,0,432
339326,216114,2012-06-19,House,"On Agreeing to the Amendment",177,247,8,0,432
339326,216115,2012-06-19,House,"On Motion to Recommit with Instructions",188,234,10,0,432
339326,216116,2012-06-19,House,"On Passage",232,188,12,0,432
339326,219594,2012-06-19,House,"On Agreeing to the Amendment",184,236,12,0,432
339326,219595,2012-06-19,House,"On Agreeing to the Amendment",156,268,8,0,432
339326,219596,2012-06-19,House,"On Agreeing to the Amendment",177,247,8,0,432
339326,219597,2012-06-19,House,"On Motion to Recommit with Instructions",188,234,10,0,432
339326,219598,2012-06-19,House,"On Passage",232,188,12,0,432
339333,218925,2011-07-19,House,"On Ordering the Previous Question",235,175,21,0,431
339333,218926,2011-07-19,House,"On Agreeing to the Resolution",236,177,19,0,432
339349,218659,2011-07-25,House,"On Agreeing to the Amendment",175,237,20,0,432
339349,218660,2011-07-25,House,"On Agreeing to the Amendment",126,284,22,0,432
339349,218661,2011-07-25,House,"On Agreeing to the Amendment",165,248,19,0,432
339349,218662,2011-07-25,House,"On Agreeing to the Amendment",221,192,19,0,432
339349,218663,2011-07-25,House,"On Agreeing to the Amendment",141,271,20,0,432
339349,218664,2011-07-27,House,"On Agreeing to the Amendment",173,251,8,0,432
339349,218665,2011-07-27,House,"On Agreeing to the Amendment",224,202,6,0,432
339349,218666,2011-07-27,House,"On Agreeing to the Amendment",184,238,10,0,432
339349,218667,2011-07-27,House,"On Agreeing to the Amendment",131,294,7,0,432
339349,218668,2011-07-27,House,"On Agreeing to the Amendment",137,291,4,0,432
339349,218669,2011-07-27,House,"On Agreeing to the Amendment",237,189,6,0,432
339349,218670,2011-07-27,House,"On Agreeing to the Amendment",215,213,4,0,432
339349,218671,2011-07-27,House,"On Agreeing to the Amendment",174,237,21,0,432
339349,218672,2011-07-27,House,"On Agreeing to the Amendment",174,250,8,0,432
339349,218673,2011-07-27,House,"On Agreeing to the Amendment",220,206,6,0,432
339349,218674,2011-07-27,House,"On Agreeing to the Amendment",235,191,6,0,432
339349,218675,2011-07-27,House,"On Agreeing to the Amendment",193,232,7,0,432
339349,218676,2011-07-28,House,"On Agreeing to the Amendment",114,314,4,0,432
339349,218677,2011-07-28,House,"On Agreeing to the Amendment",168,258,6,0,432
339349,218678,2011-07-28,House,"On Agreeing to the Amendment",161,263,8,0,432
339349,218679,2011-07-28,House,"On Agreeing to the Amendment",130,295,7,0,432
339349,218680,2011-07-28,House,"On Agreeing to the Amendment",198,227,7,0,432
339349,218681,2011-07-28,House,"On Agreeing to the Amendment",110,317,5,0,432
339349,218682,2011-07-28,House,"On Agreeing to the Amendment",181,240,11,0,432
339356,220946,2011-09-15,House,"On Motion to Recommit with Instructions",189,235,9,0,433
339356,220947,2011-09-15,House,"On Passage",238,186,9,0,433
339361,219582,2011-07-20,House,"On Ordering the Previous Question",239,183,10,0,432
339361,219583,2011-07-20,House,"On Agreeing to the Resolution",242,178,12,0,432
339407,219636,2011-07-21,House,"On Agreeing to the Resolution",239,172,21,0,432
339408,219689,2011-07-21,House,"On Question of Consideration of the Resolution",227,173,32,0,432
339408,219690,2011-07-21,House,"On Agreeing to the Resolution",238,177,17,0,432
339448,216028,2011-09-26,Senate,"On the Cloture Motion H.R. 2608",54,35,11,0,100
339448,217013,2011-09-23,Senate,"On the Motion to Table S.Amdt. 655 to H.R. 2608 (Continuing Appropriations Act, 2012)",59,36,5,0,100
339448,217014,2011-09-26,Senate,"On the Motion (Motion to Concur in the House Amdt. to the Senate Amdt. with an Amdt. No. 665)",79,12,9,0,100
339448,219281,2011-09-21,House,"On Motion to Concur in the Senate Amendment with an Amendment",195,230,8,0,433
339448,219282,2011-09-23,House,"On Motion to Concur in the Senate Amendment with an Amendment",219,203,11,0,433
339448,219283,2011-10-04,House,"On Concurring in Senate Amdt to House Amdt to Senate Amdt",352,66,15,0,433
339466,219871,2011-11-14,House,"On Motion to Suspend the Rules and Pass",385,0,48,0,433
339520,220266,2011-09-12,House,"On Motion to Suspend the Rules and Pass, as Amended",384,0,47,0,431
339534,218943,2011-12-01,House,"On Motion to Suspend the Rules and Agree",419,0,14,0,433
339535,220298,2011-07-25,House,"On Agreeing to the Resolution",205,131,96,0,432
339548,218844,2011-07-26,House,"On Agreeing to the Resolution",246,171,15,0,432
339596,219438,2011-09-15,House,"On Ordering the Previous Question",234,177,20,0,431
339596,219439,2011-09-15,House,"On Agreeing to the Resolution",239,176,18,0,433
339620,218624,2011-07-28,House,"On Agreeing to the Resolution",238,186,8,0,432
339623,219292,2011-09-20,House,"On Motion to Suspend the Rules and Pass, as Amended",412,3,18,0,433
339665,219430,2011-07-29,House,"On Ordering the Previous Question",237,185,10,0,432
339665,219431,2011-07-29,House,"On Agreeing to the Resolution",236,186,10,0,432
339666,219970,2011-09-07,House,"On Motion to Suspend the Rules and Agree",379,0,52,0,431
339668,219460,2011-07-30,House,"On Motion to Suspend the Rules and Pass, as Amended",173,246,13,0,432
339681,218893,2011-10-05,House,"On Agreeing to the Amendment",166,246,21,0,433
339681,218894,2011-10-05,House,"On Agreeing to the Amendment",162,251,20,0,433
339681,218895,2011-10-05,House,"On Agreeing to the Amendment",158,254,21,0,433
339681,218896,2011-10-05,House,"On Agreeing to the Amendment",175,248,10,0,433
339681,218897,2011-10-05,House,"On Agreeing to the Amendment",167,254,12,0,433
339681,218898,2011-10-05,House,"On Agreeing to the Amendment",169,254,10,0,433
339681,218899,2011-10-05,House,"On Agreeing to the Amendment",166,253,14,0,433
339681,218900,2011-10-05,House,"On Agreeing to the Amendment",162,262,9,0,433
339681,218901,2011-10-05,House,"On Agreeing to the Amendment",175,248,10,0,433
339681,218902,2011-10-05,House,"On Agreeing to the Amendment",176,248,9,0,433
339681,218903,2011-10-05,House,"On Agreeing to the Amendment",174,249,10,0,433
339681,218904,2011-10-05,House,"On Agreeing to the Amendment",167,256,10,0,433
339681,218905,2011-10-05,House,"On Agreeing to the Amendment",170,252,11,0,433
339681,218906,2011-10-06,House,"On Agreeing to the Amendment",172,248,13,0,433
339681,218907,2011-10-06,House,"On Agreeing to the Amendment",162,257,14,0,433
339681,218908,2011-10-06,House,"On Agreeing to the Amendment",165,258,10,0,433
339681,218909,2011-10-06,House,"On Motion to Recommit with Instructions",176,247,10,0,433
339681,218910,2011-10-06,House,"On Passage",262,161,10,0,433
339690,216555,2012-03-26,House,"On Motion to Suspend the Rules and Pass, as Amended",370,24,37,0,431
339690,220978,2012-03-26,House,"On Motion to Suspend the Rules and Pass, as Amended",370,24,37,0,431
339699,218929,2011-07-29,House,"On Agreeing to the Resolution",239,187,6,0,432
339750,220544,2011-08-01,House,"On Ordering the Previous Question",242,184,6,0,432
339750,220545,2011-08-01,House,"On Agreeing to the Resolution",249,178,5,0,432
339753,219217,2011-08-01,House,"On Motion to Suspend the Rules and Pass",421,2,9,0,432
339802,219050,2011-12-15,House,"On Motion to Suspend the Rules and Pass",416,0,17,0,433
339851,220310,2011-12-13,House,"On Motion to Suspend the Rules and Pass",420,0,13,0,433
339871,216835,2012-03-26,House,"On Motion to Suspend the Rules and Pass, as Amended",357,36,38,0,431
339871,218729,2012-03-26,House,"On Motion to Suspend the Rules and Pass, as Amended",357,36,38,0,431
339877,216836,2011-12-14,Senate,"On the Joint Resolution S.J.Res. 24",21,79,0,0,100
339887,221650,2011-09-21,House,"On Motion to Suspend the Rules and Agree",424,0,9,0,433
340222,220238,2011-11-04,House,"On Agreeing to the Amendment",174,227,32,0,433
340222,220239,2011-11-04,House,"On Agreeing to the Amendment",182,218,33,0,433
340222,220240,2011-11-04,House,"On Agreeing to the Amendment",364,37,32,0,433
340222,220241,2011-11-04,House,"On Agreeing to the Amendment",174,225,34,0,433
340222,220242,2011-11-04,House,"On Agreeing to the Amendment",161,237,35,0,433
340222,220243,2011-11-15,House,"On Agreeing to the Amendment",322,100,11,0,433
340222,220244,2011-11-15,House,"On Motion to Recommit with Instructions",189,235,9,0,433
340245,216231,2011-09-19,Senate,"On the Cloture Motion H.R. 2832",84,8,8,0,100
340245,216232,2011-09-20,Senate,"On the Amendment S.Amdt. 626 to S.Amdt. 633 to H.R. 2832 (No short title on file)",45,55,0,0,100
340245,216233,2011-09-21,Senate,"On the Amendment S.Amdt. 641 to S.Amdt. 633 to H.R. 2832 (No short title on file)",44,54,2,0,100
340245,216234,2011-09-21,Senate,"On the Amendment S.Amdt. 625 to S.Amdt. 633 to H.R. 2832 (No short title on file)",46,53,1,0,100
340245,216235,2011-09-21,Senate,"On the Amendment S.Amdt. 642 to S.Amdt. 633 to H.R. 2832 (No short title on file)",40,57,3,0,100
340245,216236,2011-09-21,Senate,"On the Amendment S.Amdt. 645 to S.Amdt. 633 to H.R. 2832 (No short title on file)",43,54,3,0,100
340245,216237,2011-09-22,Senate,"On the Amendment S.Amdt. 651 to S.Amdt. 633 to H.R. 2832 (Trade Adjustment Assistance Extension Act of 2011)",34,62,4,0,100
340245,216238,2011-09-22,Senate,"On the Amendment S.Amdt. 650 to H.R. 2832 (Trade Adjustment Assistance Extension Act of 2011)",44,52,4,0,100
340245,216239,2011-09-22,Senate,"On the Amendment S.Amdt. 634 to H.R. 2832 (Trade Adjustment Assistance Extension Act of 2011)",48,48,4,0,100
340245,216240,2011-09-22,Senate,"On the Amendment S.Amdt. 633 to H.R. 2832 (Trade Adjustment Assistance Extension Act of 2011)",69,28,3,0,100
340245,216241,2011-09-22,Senate,"On Passage of the Bill H.R. 2832",70,27,3,0,100
340245,220024,2011-10-12,House,"On Motion to Concur in the Senate Amendment",307,122,4,0,433
340333,216934,2011-09-08,Senate,"On the Motion to Proceed S.J.Res. 25",45,52,3,0,100
340336,216468,2012-03-07,House,"On Agreeing to the Amendment",168,253,11,0,432
340336,216469,2012-03-07,House,"On Motion to Recommit with Instructions",182,237,13,0,432
340336,216470,2012-03-07,House,"On Passage",265,154,13,0,432
340336,220664,2012-03-07,House,"On Agreeing to the Amendment",168,253,11,0,432
340336,220665,2012-03-07,House,"On Motion to Recommit with Instructions",182,237,13,0,432
340336,220666,2012-03-07,House,"On Passage",265,154,13,0,432
340352,218967,2011-09-08,House,"On Ordering the Previous Question",226,176,29,0,431
340352,218968,2011-09-08,House,"On Agreeing to the Resolution",237,163,31,0,431
340358,219448,2011-09-14,House,"On Passage",232,186,13,0,431
340417,220942,2011-09-15,House,"On Motion to Suspend the Rules and Pass, as Amended",391,21,21,0,433
340458,216048,2011-11-10,Senate,"On the Motion to Proceed S.J.Res. 27",41,56,3,0,100
340493,216033,2011-09-15,Senate,"On the Amendment S.Amdt. 621 to H.R. 2887 (Surface and Air Transportation Programs Extension Act of 2011)",14,84,2,0,100
340493,216034,2011-09-15,Senate,"On the Amendment S.Amdt. 622 to H.R. 2887 (Surface and Air Transportation Programs Extension Act of 2011)",36,61,3,0,100
340493,216035,2011-09-15,Senate,"On Passage of the Bill H.R. 2887",92,6,2,0,100
340582,219509,2011-09-21,House,"On Motion to Suspend the Rules and Pass, as Amended",395,25,13,0,433
340789,221476,2011-11-03,House,"On Agreeing to the Amendment",190,234,9,0,433
340789,221477,2011-11-03,House,"On Motion to Recommit with Instructions",190,236,7,0,433
340789,221478,2011-11-03,House,"On Passage",413,11,9,0,433
340796,216583,2012-06-19,House,"On Motion to Suspend the Rules and Pass, as Amended",343,78,11,0,432
340796,221061,2012-06-19,House,"On Motion to Suspend the Rules and Pass, as Amended",343,78,11,0,432
340808,219192,2011-11-03,House,"On Agreeing to the Amendment",189,234,10,0,433
340808,219193,2011-11-03,House,"On Motion to Recommit with Instructions",187,237,9,0,433
340808,219194,2011-11-03,House,"On Passage",407,17,9,0,433
341114,219607,2011-09-20,House,"On Motion to Suspend the Rules and Pass",415,0,18,0,433
341246,219198,2011-09-22,House,"On Ordering the Previous Question",237,184,12,0,433
341246,219199,2011-09-22,House,"On Agreeing to the Resolution",245,175,13,0,433
341251,218756,2011-09-21,House,"On Ordering the Previous Question",237,188,8,0,433
341251,218757,2011-09-21,House,"On Agreeing to the Resolution",238,185,10,0,433
341365,219240,2011-09-22,House,"On Ordering the Previous Question",240,180,13,0,433
341365,219241,2011-09-22,House,"On Agreeing to the Resolution",238,182,13,0,433
341413,219074,2011-09-22,House,"On Ordering the Previous Question",235,177,21,0,433
341413,219075,2011-09-22,House,"On Agreeing to the Resolution",238,176,19,0,433
341465,216243,2012-04-16,House,"On Motion to Suspend the Rules and Pass",377,0,54,0,431
341465,220030,2012-04-16,House,"On Motion to Suspend the Rules and Pass",377,0,54,0,431
341520,216862,2011-10-03,Senate,"On the Cloture Motion S. 1619",79,19,2,0,100
341520,216863,2011-10-06,Senate,"On the Cloture Motion S. 1619",62,38,0,0,100
341520,216864,2011-10-11,Senate,"On Passage of the Bill S. 1619",63,35,2,0,100
341520,218831,2011-10-06,Senate,"On the Decision of the Chair S. 1619",48,51,1,0,100
341542,221623,2011-11-29,House,"On Motion to Suspend the Rules and Pass, as Amended",389,15,29,0,433
341571,220536,2011-12-02,House,"On Agreeing to the Amendment",187,232,14,0,433
341571,220537,2011-12-02,House,"On Agreeing to the Amendment",162,250,21,0,433
341571,220538,2011-12-02,House,"On Agreeing to the Amendment",171,242,20,0,433
341571,220539,2011-12-02,House,"On Agreeing to the Amendment",174,247,12,0,433
341571,220540,2011-12-02,House,"On Agreeing to the Amendment",175,247,11,0,433
341571,220541,2011-12-02,House,"On Motion to Recommit with Instructions",186,233,14,0,433
341571,220542,2011-12-02,House,"On Passage",253,167,13,0,433
341860,216110,2011-10-12,Senate,"On Passage of the Bill H.R. 3079",77,22,1,0,100
341860,219577,2011-10-12,House,"On Passage",300,129,4,0,433
341866,221000,2011-10-04,House,"On Agreeing to the Resolution",257,165,11,0,433
341873,216105,2011-10-12,Senate,"On Passage of the Bill H.R. 3080",83,15,2,0,100
341873,219572,2011-10-12,House,"On Passage",278,151,4,0,433
341874,216106,2011-10-12,Senate,"On Passage of the Bill H.R. 3078",66,33,1,0,100
341874,219573,2011-10-12,House,"On Motion to Recommit with Instructions",192,236,5,0,433
341874,219574,2011-10-12,House,"On Passage",262,167,4,0,433
341996,219175,2011-11-30,House,"On Motion to Rise With Recommendation That Enacting Clause Be Stricken",176,241,16,0,433
341996,219176,2011-11-30,House,"On Agreeing to the Amendment",187,228,18,0,433
341996,219177,2011-11-30,House,"On Agreeing to the Amendment",181,239,13,0,433
341996,219178,2011-11-30,House,"On Agreeing to the Amendment",200,221,12,0,433
341996,219179,2011-11-30,House,"On Agreeing to the Amendment",188,236,9,0,433
341996,219180,2011-11-30,House,"On Motion to Recommit with Instructions",185,239,9,0,433
341996,219181,2011-11-30,House,"On Passage",235,188,10,0,433
342074,221206,2011-10-11,House,"On Agreeing to the Resolution",281,128,24,0,433
342081,216677,2011-10-06,Senate,"On the Cloture Motion S. 1660",50,49,1,0,100
342088,216925,2012-01-23,House,"On Motion to Suspend the Rules and Pass, as Amended",373,1,59,0,433
342088,218971,2012-01-23,House,"On Motion to Suspend the Rules and Pass, as Amended",373,1,59,0,433
342211,218733,2011-10-14,House,"On Ordering the Previous Question",237,166,30,0,433
342211,218734,2011-10-14,House,"On Agreeing to the Resolution",244,163,26,0,433
342295,218755,2011-10-13,House,"On Agreeing to the Resolution",248,173,12,0,433
342310,216847,2012-12-30,House,"On Motion to Suspend the Rules and Pass, as Amended",390,0,41,0,431
342310,218802,2012-12-30,House,"On Motion to Suspend the Rules and Pass, as Amended",390,0,41,0,431
342349,220066,2011-12-12,House,"On Motion to Suspend the Rules and Pass",351,0,82,0,433
342425,216208,2012-12-20,House,"On Motion to Suspend the Rules and Pass",421,1,9,0,431
342425,219912,2012-12-20,House,"On Motion to Suspend the Rules and Pass",421,1,9,0,431
342592,216928,2011-10-19,Senate,"On Cloture on the Motion to Proceed S. 1726",57,43,0,0,100
342600,216906,2011-10-19,Senate,"On Cloture on the Motion to Proceed S. 1723",50,50,0,0,100
342721,220311,2011-12-13,House,"On Motion to Suspend the Rules and Pass",415,0,18,0,433
342724,216328,2012-02-15,House,"On Motion to Suspend the Rules and Pass",419,0,14,0,433
342724,220334,2012-02-15,House,"On Motion to Suspend the Rules and Pass",419,0,14,0,433
342736,216302,2012-02-15,House,"On Motion to Suspend the Rules and Pass",412,0,21,0,433
342736,220186,2012-02-15,House,"On Motion to Suspend the Rules and Pass",412,0,21,0,433
342740,221380,2011-10-25,House,"On Agreeing to the Resolution",245,178,10,0,433
342792,218713,2011-10-26,House,"On Ordering the Previous Question",243,178,12,0,433
342792,218714,2011-10-26,House,"On Agreeing to the Resolution",253,172,8,0,433
343077,216644,2011-11-03,Senate,"On the Motion to Proceed S. 1769",51,49,0,0,100
343104,216793,2012-03-27,House,"On Motion to Suspend the Rules and Pass",414,5,12,0,431
343104,221637,2012-03-27,House,"On Motion to Suspend the Rules and Pass",414,5,12,0,431
343105,220680,2011-11-03,House,"On Ordering the Previous Question",241,184,8,0,433
343120,216386,2011-11-03,Senate,"On the Motion to Proceed S. 1786",47,53,0,0,100
343135,220013,2011-11-04,House,"On Motion to Suspend the Rules and Pass",387,2,44,0,433
343155,220842,2011-11-04,House,"On Ordering the Previous Question",234,177,22,0,433
343155,220843,2011-11-04,House,"On Agreeing to the Resolution",245,166,22,0,433
343188,216823,2012-03-27,House,"On Agreeing to the Amendment",196,219,16,0,431
343188,216824,2012-03-27,House,"On Agreeing to the Amendment",179,238,14,0,431
343188,216825,2012-03-27,House,"On Agreeing to the Amendment",194,222,15,0,431
343188,216826,2012-03-27,House,"On Motion to Recommit with Instructions",184,236,11,0,431
343188,216827,2012-03-27,House,"On Passage",247,174,10,0,431
343188,218612,2012-03-27,House,"On Agreeing to the Amendment",196,219,16,0,431
343188,218613,2012-03-27,House,"On Agreeing to the Amendment",179,238,14,0,431
343188,218614,2012-03-27,House,"On Agreeing to the Amendment",194,222,15,0,431
343188,218615,2012-03-27,House,"On Motion to Recommit with Instructions",184,236,11,0,431
343188,218616,2012-03-27,House,"On Passage",247,174,10,0,431
344411,216680,2012-03-22,Senate,"On the Cloture Motion S. 1789",51,46,3,0,100
344411,216681,2012-04-17,Senate,"On Cloture on the Motion to Proceed S. 1789",74,22,4,0,100
344411,216682,2012-04-24,Senate,"On the Motion (Motion to Waive All Applicable Budgetary Discipline Re: Amdt. No. 2000 As Modified)",62,37,1,0,100
344411,216683,2012-04-24,Senate,"On the Amendment S.Amdt. 2033 to S.Amdt. 2000 to S. 1789 (21st Century Postal Service Act of 2012)",30,69,1,0,100
344411,216684,2012-04-24,Senate,"On the Amendment S.Amdt. 2061 to S.Amdt. 2000 to S. 1789 (21st Century Postal Service Act of 2012)",33,65,2,0,100
344411,216685,2012-04-24,Senate,"On the Amendment S.Amdt. 2043 to S.Amdt. 2000 to S. 1789 (21st Century Postal Service Act of 2012)",43,56,1,0,100
344411,216686,2012-04-24,Senate,"On the Amendment S.Amdt. 2034 to S.Amdt. 2000 to S. 1789 (21st Century Postal Service Act of 2012)",46,53,1,0,100
344411,216687,2012-04-24,Senate,"On the Amendment S.Amdt. 2083 to S.Amdt. 2000 to S. 1789 (21st Century Postal Service Act of 2012)",29,70,1,0,100
344411,216688,2012-04-24,Senate,"On the Amendment S.Amdt. 2049 to S.Amdt. 2000 to S. 1789 (21st Century Postal Service Act of 2012)",57,42,1,0,100
344411,216689,2012-04-24,Senate,"On the Amendment S.Amdt. 2025 to S.Amdt. 2000 to S. 1789 (21st Century Postal Service Act of 2012)",35,64,1,0,100
344411,216690,2012-04-25,Senate,"On the Amendment S.Amdt. 2079 to S.Amdt. 2000 to S. 1789 (21st Century Postal Service Act of 2012)",43,53,4,0,100
344411,216691,2012-04-25,Senate,"On the Amendment S.Amdt. 2028 to S.Amdt. 2000 to S. 1789 (21st Century Postal Service Act of 2012)",35,64,1,0,100
344411,216692,2012-04-25,Senate,"On the Amendment S.Amdt. 2039 to S.Amdt. 2000 to S. 1789 (21st Century Postal Service Act of 2012)",23,76,1,0,100
344411,216693,2012-04-25,Senate,"On the Amendment S.Amdt. 2042 to S.Amdt. 2000 to S. 1789 (21st Century Postal Service Act of 2012)",44,54,2,0,100
344411,216694,2012-04-25,Senate,"On the Amendment S.Amdt. 2046 to S.Amdt. 2000 to S. 1789 (21st Century Postal Service Act of 2012)",46,53,1,0,100
344411,216695,2012-04-25,Senate,"On Passage of the Bill S. 1789",62,37,1,0,100
344427,216169,2012-09-21,House,"On Agreeing to the Amendment",174,229,26,0,429
344427,216170,2012-09-21,House,"On Agreeing to the Amendment",178,229,22,0,429
344427,216171,2012-09-21,House,"On Agreeing to the Amendment",242,168,19,0,429
344427,216172,2012-09-21,House,"On Agreeing to the Amendment",164,246,19,0,429
344427,216173,2012-09-21,House,"On Agreeing to the Amendment",164,247,18,0,429
344427,216174,2012-09-21,House,"On Agreeing to the Amendment",247,163,19,0,429
344427,216175,2012-09-21,House,"On Agreeing to the Amendment",160,250,19,0,429
344427,216176,2012-09-21,House,"On Agreeing to the Amendment",168,243,18,0,429
344427,216177,2012-09-21,House,"On Agreeing to the Amendment",228,183,18,0,429
344427,216178,2012-09-21,House,"On Agreeing to the Amendment",226,181,22,0,429
344427,216179,2012-09-21,House,"On Motion to Recommit with Instructions",173,233,23,0,429
344427,216180,2012-09-21,House,"On Passage",233,175,21,0,429
344427,219772,2012-09-21,House,"On Agreeing to the Amendment",174,229,26,0,429
344427,219773,2012-09-21,House,"On Agreeing to the Amendment",178,229,22,0,429
344427,219774,2012-09-21,House,"On Agreeing to the Amendment",242,168,19,0,429
344427,219775,2012-09-21,House,"On Agreeing to the Amendment",164,246,19,0,429
344427,219776,2012-09-21,House,"On Agreeing to the Amendment",164,247,18,0,429
344427,219777,2012-09-21,House,"On Agreeing to the Amendment",247,163,19,0,429
344427,219778,2012-09-21,House,"On Agreeing to the Amendment",160,250,19,0,429
344427,219779,2012-09-21,House,"On Agreeing to the Amendment",168,243,18,0,429
344427,219780,2012-09-21,House,"On Agreeing to the Amendment",228,183,18,0,429
344427,219781,2012-09-21,House,"On Agreeing to the Amendment",226,181,22,0,429
344427,219782,2012-09-21,House,"On Motion to Recommit with Instructions",173,233,23,0,429
344427,219783,2012-09-21,House,"On Passage",233,175,21,0,429
344439,216190,2012-04-26,House,"On Agreeing to the Amendment",167,243,21,0,431
344439,216191,2012-04-26,House,"On Agreeing to the Amendment",412,0,19,0,431
344439,216192,2012-04-26,House,"On Agreeing to the Amendment",410,3,18,0,431
344439,216193,2012-04-26,House,"On Agreeing to the Amendment",415,0,16,0,431
344439,216194,2012-04-26,House,"On Agreeing to the Amendment",416,0,15,0,431
344439,216195,2012-04-26,House,"On Agreeing to the Amendment",414,1,16,0,431
344439,216196,2012-04-26,House,"On Agreeing to the Amendment",413,3,15,0,431
344439,216197,2012-04-26,House,"On Motion to Recommit with Instructions",183,233,15,0,431
344439,216198,2012-04-26,House,"On Passage",248,168,15,0,431
344439,219812,2012-04-26,House,"On Agreeing to the Amendment",167,243,21,0,431
344439,219813,2012-04-26,House,"On Agreeing to the Amendment",412,0,19,0,431
344439,219814,2012-04-26,House,"On Agreeing to the Amendment",410,3,18,0,431
344439,219815,2012-04-26,House,"On Agreeing to the Amendment",415,0,16,0,431
344439,219816,2012-04-26,House,"On Agreeing to the Amendment",416,0,15,0,431
344439,219817,2012-04-26,House,"On Agreeing to the Amendment",414,1,16,0,431
344439,219818,2012-04-26,House,"On Agreeing to the Amendment",413,3,15,0,431
344439,219819,2012-04-26,House,"On Motion to Recommit with Instructions",183,233,15,0,431
344439,219820,2012-04-26,House,"On Passage",248,168,15,0,431
344440,216828,2012-04-25,House,"On Motion to Suspend the Rules and Pass, as Amended",312,111,8,0,431
344440,218630,2012-04-25,House,"On Motion to Suspend the Rules and Pass, as Amended",312,111,8,0,431
344449,218593,2011-11-30,House,"On Ordering the Previous Question",239,184,10,0,433
344449,218594,2011-11-30,House,"On Agreeing to the Resolution",239,178,16,0,433
344459,218655,2011-11-17,House,"On Ordering the Previous Question",243,173,17,0,433
344459,218656,2011-11-17,House,"On Agreeing to the Resolution",248,169,16,0,433
344472,220943,2011-12-14,House,"On Motion to Suspend the Rules and Pass",416,0,17,0,433
344557,216628,2012-05-31,House,"On Motion to Suspend the Rules and Pass, as Amended",246,168,17,0,431
344557,221154,2012-05-31,House,"On Motion to Suspend the Rules and Pass, as Amended",246,168,17,0,431
344595,220531,2011-12-01,House,"On Motion to Recommit with Instructions",190,236,7,0,433
344595,220532,2011-12-01,House,"On Passage",235,190,8,0,433
344596,216898,2011-12-01,Senate,"On the Motion to Proceed S. 1917",51,49,0,0,100
344605,217062,2012-02-08,House,"On Agreeing to the Amendment",128,300,5,0,433
344605,217063,2012-02-08,House,"On Passage",254,173,6,0,433
344605,219499,2012-02-08,House,"On Agreeing to the Amendment",128,300,5,0,433
344605,219500,2012-02-08,House,"On Passage",254,173,6,0,433
344611,216406,2012-02-15,House,"On Agreeing to the Amendment",173,249,11,0,433
344611,216407,2012-02-15,House,"On Agreeing to the Amendment",173,254,6,0,433
344611,216408,2012-02-15,House,"On Agreeing to the Amendment",149,276,8,0,433
344611,216409,2012-02-15,House,"On Agreeing to the Amendment",193,234,6,0,433
344611,216410,2012-02-15,House,"On Agreeing to the Amendment",160,265,8,0,433
344611,216411,2012-02-15,House,"On Agreeing to the Amendment",160,267,6,0,433
344611,216412,2012-02-15,House,"On Agreeing to the Amendment",169,257,7,0,433
344611,216413,2012-02-15,House,"On Agreeing to the Amendment",266,159,8,0,433
344611,216414,2012-02-15,House,"On Agreeing to the Amendment",188,236,9,0,433
344611,216415,2012-02-16,House,"On Agreeing to the Amendment",167,253,13,0,433
344611,216416,2012-02-16,House,"On Agreeing to the Amendment",189,228,16,0,433
344611,216417,2012-02-16,House,"On Agreeing to the Amendment",250,171,12,0,433
344611,216418,2012-02-16,House,"On Agreeing to the Amendment",168,254,11,0,433
344611,216419,2012-02-16,House,"On Agreeing to the Amendment",183,238,12,0,433
344611,216420,2012-02-16,House,"On Agreeing to the Amendment",244,177,12,0,433
344611,216421,2012-02-16,House,"On Motion to Recommit with Instructions",176,241,16,0,433
344611,216422,2012-02-16,House,"On Passage",237,187,10,0,434
344611,220484,2012-02-15,House,"On Agreeing to the Amendment",173,249,11,0,433
344611,220485,2012-02-15,House,"On Agreeing to the Amendment",173,254,6,0,433
344611,220486,2012-02-15,House,"On Agreeing to the Amendment",149,276,8,0,433
344611,220487,2012-02-15,House,"On Agreeing to the Amendment",193,234,6,0,433
344611,220488,2012-02-15,House,"On Agreeing to the Amendment",160,265,8,0,433
344611,220489,2012-02-15,House,"On Agreeing to the Amendment",160,267,6,0,433
344611,220490,2012-02-15,House,"On Agreeing to the Amendment",169,257,7,0,433
344611,220491,2012-02-15,House,"On Agreeing to the Amendment",266,159,8,0,433
344611,220492,2012-02-15,House,"On Agreeing to the Amendment",188,236,9,0,433
344611,220493,2012-02-16,House,"On Agreeing to the Amendment",167,253,13,0,433
344611,220494,2012-02-16,House,"On Agreeing to the Amendment",189,228,16,0,433
344611,220495,2012-02-16,House,"On Agreeing to the Amendment",250,171,12,0,433
344611,220496,2012-02-16,House,"On Agreeing to the Amendment",168,254,11,0,433
344611,220497,2012-02-16,House,"On Agreeing to the Amendment",183,238,12,0,433
344611,220498,2012-02-16,House,"On Agreeing to the Amendment",244,177,12,0,433
344611,220499,2012-02-16,House,"On Motion to Recommit with Instructions",176,241,16,0,433
344611,220500,2012-02-16,House,"On Passage",237,187,10,0,434
344647,221213,2011-12-06,House,"On Ordering the Previous Question",236,184,13,0,433
344647,221214,2011-12-06,House,"On Agreeing to the Resolution",235,180,18,0,433
344699,218974,2011-11-18,House,"On Agreeing to the Resolution",239,167,27,0,433
344723,218977,2011-11-17,House,"On Agreeing to the Resolution",262,156,15,0,433
344745,216756,2012-07-23,House,"On Motion to Suspend the Rules and Pass",379,0,52,0,431
344745,221384,2012-07-23,House,"On Motion to Suspend the Rules and Pass",379,0,52,0,431
344763,216696,2011-11-29,Senate,"On the Amendment S.Amdt. 1107 to S. 1867 (National Defense Authorization Act for Fiscal Year 2012)",38,60,2,0,100
344763,216697,2011-11-29,Senate,"On the Amendment S.Amdt. 1064 to S. 1867 (National Defense Authorization Act for Fiscal Year 2012)",30,67,3,0,100
344763,216698,2011-11-30,Senate,"On the Cloture Motion S. 1867",88,12,0,0,100
344763,216699,2011-12-01,Senate,"On the Amendment S.Amdt. 1125 to S. 1867 (National Defense Authorization Act for Fiscal Year 2012)",45,55,0,0,100
344763,216700,2011-12-01,Senate,"On the Amendment S.Amdt. 1126 to S. 1867 (National Defense Authorization Act for Fiscal Year 2012)",45,55,0,0,100
344763,216701,2011-12-01,Senate,"On the Amendment S.Amdt. 1456 to S. 1867 (National Defense Authorization Act for Fiscal Year 2012)",99,1,0,0,100
344763,216702,2011-12-01,Senate,"On the Amendment S.Amdt. 1414 to S. 1867 (National Defense Authorization Act for Fiscal Year 2012)",100,0,0,0,100
344763,216703,2011-12-01,Senate,"On the Amendment S.Amdt. 1274 to S. 1867 (National Defense Authorization Act for Fiscal Year 2012)",41,59,0,0,100
344763,216704,2011-12-01,Senate,"On Passage of the Bill S. 1867",93,7,0,0,100
344783,220605,2011-11-15,House,"On Agreeing to the Resolution",271,153,9,0,433
344810,216648,2012-02-09,Senate,"On Cloture on the Motion to Proceed S. 1813",85,11,4,0,100
344810,216649,2012-02-17,Senate,"On the Cloture Motion S.Amdt. 1633 to S. 1813 (MAP-21)",54,42,4,0,100
344810,216650,2012-03-01,Senate,"On the Motion to Table S.Amdt. 1520 to S.Amdt. 1730 to S. 1813 (MAP-21)",51,48,1,0,100
344810,216651,2012-03-06,Senate,"On the Cloture Motion S.Amdt. 1761 to S. 1813 (MAP-21)",52,44,4,0,100
344810,216652,2012-03-06,Senate,"On the Cloture Motion S.Amdt. 1761 to S. 1813 (MAP-21)",52,44,4,0,100
344810,216653,2012-03-08,Senate,"On the Amendment S.Amdt. 1535 to S. 1813 (MAP-21)",43,55,2,0,100
344810,216654,2012-03-08,Senate,"On the Amendment S.Amdt. 1825 to S. 1813 (MAP-21)",82,16,2,0,100
344810,216655,2012-03-08,Senate,"On the Amendment S.Amdt. 1660 to S. 1813 (MAP-21)",52,46,2,0,100
344810,216656,2012-03-08,Senate,"On the Amendment S.Amdt. 1738 to S. 1813 (MAP-21)",52,46,2,0,100
344810,216657,2012-03-08,Senate,"On the Amendment S.Amdt. 1822 to S. 1813 (MAP-21)",76,22,2,0,100
344810,216658,2012-03-08,Senate,"On the Amendment S.Amdt. 1817 to S. 1813 (MAP-21)",33,65,2,0,100
344810,216659,2012-03-08,Senate,"On the Amendment S.Amdt. 1537 to S. 1813 (MAP-21)",56,42,2,0,100
344810,216660,2012-03-08,Senate,"On the Motion (Motion to Waive All Applicable Budgetary Discipline Re: S.1813)",66,31,3,0,100
344810,216661,2012-03-13,Senate,"On the Amendment S.Amdt. 1756 to S. 1813 (MAP-21)",30,67,3,0,100
344810,216662,2012-03-13,Senate,"On the Amendment S.Amdt. 1759 to S. 1813 (MAP-21)",50,47,3,0,100
344810,216663,2012-03-13,Senate,"On the Amendment S.Amdt. 1826 to S. 1813 (MAP-21)",41,57,2,0,100
344810,216664,2012-03-13,Senate,"On the Amendment S.Amdt. 1812 to S. 1813 (MAP-21)",49,49,2,0,100
344810,216665,2012-03-13,Senate,"On the Amendment S.Amdt. 1589 to S. 1813 (MAP-21)",26,72,2,0,100
344810,216666,2012-03-13,Senate,"On the Amendment S.Amdt. 1782 to S. 1813 (MAP-21)",51,47,2,0,100
344810,216667,2012-03-13,Senate,"On the Amendment S.Amdt. 1517 to S. 1813 (MAP-21)",28,70,2,0,100
344810,216668,2012-03-13,Senate,"On the Amendment S.Amdt. 1736 to S. 1813 (MAP-21)",30,68,2,0,100
344810,216669,2012-03-13,Senate,"On the Motion (Motion to Waive All Applicable Budgetary Provisions Re: Corker Amdt. No. 1785, As Modified)",40,58,2,0,100
344810,216670,2012-03-13,Senate,"On the Amendment S.Amdt. 1742 to S. 1813 (MAP-21)",12,86,2,0,100
344810,216671,2012-03-14,Senate,"On the Amendment S.Amdt. 1816 to S.Amdt. 1761 to S. 1813 (MAP-21)",76,20,4,0,100
344810,216672,2012-03-14,Senate,"On the Motion (Motion to Waive All Applicable Budgetary Disciple Re: Paul Amdt. No. 1556)",42,54,4,0,100
344810,216673,2012-03-14,Senate,"On Passage of the Bill S. 1813",74,22,4,0,100
344837,216904,2011-12-01,Senate,"On the Motion to Proceed S. 1931",20,78,2,0,100
344837,216905,2011-12-08,Senate,"On the Motion to Proceed S. 1931",22,76,2,0,100
344885,216810,2012-04-26,Senate,"On the Amendment S.Amdt. 2094 to S.Amdt. 2093 to S. 1925 (Violence Against Women Reauthorization Act of 2011)",57,41,2,0,100
344885,216811,2012-04-26,Senate,"On the Amendment S.Amdt. 2086 to S.Amdt. 2093 to S. 1925 (Violence Against Women Reauthorization Act of 2011)",50,48,2,0,100
344885,216812,2012-04-26,Senate,"On the Amendment S.Amdt. 2095 to S.Amdt. 2093 to S. 1925 (Violence Against Women Reauthorization Act of 2011)",37,62,1,0,100
344885,216813,2012-04-26,Senate,"On Passage of the Bill S. 1925",68,31,1,0,100
344914,216582,2012-06-21,Senate,"On the Cloture Motion S. 1940",96,2,2,0,100
344919,216930,2012-02-01,House,"On Motion to Suspend the Rules and Pass, as Amended",395,27,10,0,432
344919,218984,2012-02-01,House,"On Motion to Suspend the Rules and Pass, as Amended",395,27,10,0,432
345058,216980,2011-12-08,Senate,"On the Motion to Proceed S. 1944",50,48,2,0,100
345064,219106,2011-12-08,House,"On Ordering the Previous Question",241,173,19,0,433
345064,219107,2011-12-08,House,"On Agreeing to the Resolution",249,161,23,0,433
345161,216638,2012-01-24,House,"On Motion to Instruct Conferees",397,16,20,0,433
345161,216639,2012-02-01,House,"On Motion to Instruct Conferees",184,236,12,0,432
345161,216640,2012-02-08,House,"On Motion to Instruct Conferees",405,15,13,0,433
345161,216641,2012-02-17,House,"On Agreeing to the Conference Report",293,132,8,0,433
345161,216642,2011-12-17,Senate,"On the Amendment S.Amdt. 1465 to H.R. 3630 (Middle Class Tax Relief and Job Creation Act of 2011)",89,10,1,0,100
345161,216643,2012-02-17,Senate,"On the Conference Report H.R. 3630",60,36,4,0,100
345161,221180,2011-12-13,House,"On Motion to Recommit with Instructions",183,244,6,0,433
345161,221181,2011-12-13,House,"On Passage",234,193,6,0,433
345161,221182,2011-12-20,House,"On Motion to Go to Conference",229,193,11,0,433
345161,221183,2011-12-20,House,"On Motion to Instruct Conferees",183,238,12,0,433
345161,221184,2012-01-24,House,"On Motion to Instruct Conferees",397,16,20,0,433
345161,221185,2012-02-01,House,"On Motion to Instruct Conferees",184,236,12,0,432
345161,221186,2012-02-08,House,"On Motion to Instruct Conferees",405,15,13,0,433
345161,221187,2012-02-17,House,"On Agreeing to the Conference Report",293,132,8,0,433
345177,218603,2011-12-13,House,"On Question of Consideration of the Resolution",227,174,32,0,433
345177,218604,2011-12-13,House,"On Ordering the Previous Question",236,182,15,0,433
345177,218605,2011-12-13,House,"On Agreeing to the Resolution",236,180,17,0,433
345187,216584,2012-02-03,House,"On Motion to Recommit with Instructions",177,238,17,0,432
345187,216585,2012-02-03,House,"On Passage",235,177,20,0,432
345187,221094,2012-02-03,House,"On Motion to Recommit with Instructions",177,238,17,0,432
345187,221095,2012-02-03,House,"On Passage",235,177,20,0,432
345190,217015,2012-02-02,House,"On Agreeing to the Amendment",174,244,14,0,432
345190,217016,2012-02-02,House,"On Agreeing to the Amendment",177,237,18,0,432
345190,217017,2012-02-02,House,"On Agreeing to the Amendment",171,243,18,0,432
345190,217018,2012-02-02,House,"On Agreeing to the Amendment",173,243,16,0,432
345190,217019,2012-02-02,House,"On Agreeing to the Amendment",174,245,13,0,432
345190,217020,2012-02-02,House,"On Motion to Recommit with Instructions",183,237,12,0,432
345190,217021,2012-02-02,House,"On Passage",242,179,11,0,432
345190,219332,2012-02-02,House,"On Agreeing to the Amendment",174,244,14,0,432
345190,219333,2012-02-02,House,"On Agreeing to the Amendment",177,237,18,0,432
345190,219334,2012-02-02,House,"On Agreeing to the Amendment",171,243,18,0,432
345190,219335,2012-02-02,House,"On Agreeing to the Amendment",173,243,16,0,432
345190,219336,2012-02-02,House,"On Agreeing to the Amendment",174,245,13,0,432
345190,219337,2012-02-02,House,"On Motion to Recommit with Instructions",183,237,12,0,432
345190,219338,2012-02-02,House,"On Passage",242,179,11,0,432
345197,217027,2012-02-07,House,"On Agreeing to the Amendment",187,238,8,0,433
345197,217028,2012-02-07,House,"On Motion to Recommit with Instructions",190,238,5,0,433
345197,217029,2012-02-07,House,"On Passage",245,180,8,0,433
345197,219382,2012-02-07,House,"On Agreeing to the Amendment",187,238,8,0,433
345197,219383,2012-02-07,House,"On Motion to Recommit with Instructions",190,238,5,0,433
345197,219384,2012-02-07,House,"On Passage",245,180,8,0,433
345282,216761,2012-03-07,House,"On Agreeing to the Amendment",164,245,23,0,432
345282,216762,2012-03-07,House,"On Agreeing to the Amendment",169,244,19,0,432
345282,216763,2012-03-07,House,"On Agreeing to the Amendment",161,259,12,0,432
345282,216764,2012-03-07,House,"On Agreeing to the Amendment",185,236,11,0,432
345282,216765,2012-03-08,House,"On Agreeing to the Amendment",175,239,18,0,432
345282,216766,2012-03-08,House,"On Agreeing to the Amendment",172,236,24,0,432
345282,216767,2012-03-08,House,"On Motion to Recommit with Instructions",170,244,18,0,432
345282,216768,2012-03-08,House,"On Passage",390,23,19,0,432
345282,216769,2012-03-27,House,"On Motion to Suspend the Rules and Concur in the Senate Amendment",380,41,10,0,431
345282,216770,2012-03-20,Senate,"On the Cloture Motion S.Amdt. 1833 to H.R. 3606 (Reopening American Capital Markets to Emerging Growth Companies Act of 2011)",54,45,1,0,100
345282,216771,2012-03-20,Senate,"On the Cloture Motion S.Amdt. 1836 to H.R. 3606 (Reopening American Capital Markets to Emerging Growth Companies Act of 2011)",55,44,1,0,100
345282,216772,2012-03-21,Senate,"On the Cloture Motion H.R. 3606",76,22,2,0,100
345282,216773,2012-03-22,Senate,"On the Amendment S.Amdt. 1884 to H.R. 3606 (Reopening American Capital Markets to Emerging Growth Companies Act of 2011)",64,35,1,0,100
345282,216774,2012-03-22,Senate,"On Passage of the Bill H.R. 3606",73,26,1,0,100
345282,221404,2012-03-07,House,"On Agreeing to the Amendment",164,245,23,0,432
345282,221405,2012-03-07,House,"On Agreeing to the Amendment",169,244,19,0,432
345282,221406,2012-03-07,House,"On Agreeing to the Amendment",161,259,12,0,432
345282,221407,2012-03-07,House,"On Agreeing to the Amendment",185,236,11,0,432
345282,221408,2012-03-08,House,"On Agreeing to the Amendment",175,239,18,0,432
345282,221409,2012-03-08,House,"On Agreeing to the Amendment",172,236,24,0,432
345282,221410,2012-03-08,House,"On Motion to Recommit with Instructions",170,244,18,0,432
345282,221411,2012-03-08,House,"On Passage",390,23,19,0,432
345282,221412,2012-03-27,House,"On Motion to Suspend the Rules and Concur in the Senate Amendment",380,41,10,0,431
345288,218932,2011-12-14,House,"On Ordering the Previous Question",235,173,25,0,433
345288,218933,2011-12-14,House,"On Agreeing to the Resolution",245,169,19,0,433
345315,216484,2011-12-17,Senate,"On Passage of the Bill H.R. 3672",72,27,1,0,100
345315,220692,2011-12-16,House,"On Passage",351,67,15,0,433
345338,216126,2011-12-17,Senate,"On the Concurrent Resolution H.Con.Res. 94",43,56,1,0,100
345338,219633,2011-12-16,House,"On Agreeing to the Concurrent Resolution",255,165,13,0,433
345360,219784,2011-12-16,House,"On Ordering the Previous Question",239,179,15,0,433
345360,219785,2011-12-16,House,"On Agreeing to the Resolution",252,164,17,0,433
345682,216209,2012-07-17,House,"On Motion to Suspend the Rules and Pass",378,11,42,0,431
345682,219916,2012-07-17,House,"On Motion to Suspend the Rules and Pass",378,11,42,0,431
345792,217070,2012-03-05,House,"On Motion to Suspend the Rules and Pass",362,2,69,0,433
345792,219549,2012-03-05,House,"On Motion to Suspend the Rules and Pass",362,2,69,0,433
345839,221689,2011-12-20,House,"On Ordering the Previous Question",233,187,13,0,433
345839,221690,2011-12-20,House,"On Agreeing to the Resolution",231,187,15,0,433
345840,218573,2011-12-20,House,"On Agreeing to the Resolution",226,185,22,0,433
345863,221611,2011-12-20,House,"On Motion to Table",231,188,14,0,433
361088,216712,2012-01-18,House,"On Passage",239,176,18,0,433
361088,216713,2012-01-26,Senate,"On the Motion to Proceed H.J.Res. 98",44,52,4,0,100
361088,221241,2012-01-18,House,"On Passage",239,176,18,0,433
369197,216910,2012-01-18,House,"On Ordering the Previous Question",238,176,19,0,433
369197,218936,2012-01-18,House,"On Ordering the Previous Question",238,176,19,0,433
371494,216775,2012-12-18,House,"On Motion to Suspend the Rules and Agree to the Senate Amendment",386,6,39,0,431
371494,221448,2012-12-18,House,"On Motion to Suspend the Rules and Agree to the Senate Amendment",386,6,39,0,431
371922,216927,2012-01-24,House,"On Motion to Suspend the Rules and Agree",410,1,22,0,433
371922,218976,2012-01-24,House,"On Motion to Suspend the Rules and Agree",410,1,22,0,433
377102,216939,2012-07-31,House,"On Motion to Suspend the Rules and Pass, as Amended",220,154,57,0,431
377102,219009,2012-07-31,House,"On Motion to Suspend the Rules and Pass, as Amended",220,154,57,0,431
377209,217082,2012-01-25,House,"On Motion to Suspend the Rules and Pass",408,0,25,0,433
377209,220022,2012-01-25,House,"On Motion to Suspend the Rules and Pass",408,0,25,0,433
378945,216272,2012-01-31,House,"On Agreeing to the Resolution",251,157,24,0,432
378945,220138,2012-01-31,House,"On Agreeing to the Resolution",251,157,24,0,432
382341,216303,2012-07-23,House,"On Motion to Suspend the Rules and Pass",126,254,51,0,431
382341,220191,2012-07-23,House,"On Motion to Suspend the Rules and Pass",126,254,51,0,431
383627,216929,2012-02-01,House,"On Motion to Suspend the Rules and Pass",309,117,6,0,432
383627,218983,2012-02-01,House,"On Motion to Suspend the Rules and Pass",309,117,6,0,432
383677,216559,2012-02-09,House,"On Motion to Suspend the Rules and Pass, as Amended",417,2,14,0,433
383677,216560,2012-01-30,Senate,"On Cloture on the Motion to Proceed S. 2038",93,2,5,0,100
383677,216561,2012-02-02,Senate,"On the Amendment S.Amdt. 1484 to S.Amdt. 1470 to S. 2038 (Stop Trading on Congressional Knowledge Act of 2012)",37,61,2,0,100
383677,216562,2012-02-02,Senate,"On the Amendment S.Amdt. 1487 to S.Amdt. 1470 to S. 2038 (Stop Trading on Congressional Knowledge Act of 2012)",48,51,1,0,100
383677,216563,2012-02-02,Senate,"On the Amendment S.Amdt. 1511 to S.Amdt. 1470 to S. 2038 (Stop Trading on Congressional Knowledge Act of 2012)",81,18,1,0,100
383677,216564,2012-02-02,Senate,"On the Amendment S.Amdt. 1491 to S.Amdt. 1470 to S. 2038 (Stop Trading on Congressional Knowledge Act of 2012)",58,41,1,0,100
383677,216565,2012-02-02,Senate,"On the Amendment S.Amdt. 1472 to S.Amdt. 1470 to S. 2038 (Stop Trading on Congressional Knowledge Act of 2012)",40,59,1,0,100
383677,216566,2012-02-02,Senate,"On the Amendment S.Amdt. 1500 to S.Amdt. 1470 to S. 2038 (Stop Trading on Congressional Knowledge Act of 2012)",26,73,1,0,100
383677,216567,2012-02-02,Senate,"On the Amendment S.Amdt. 1473 to S.Amdt. 1470 to S. 2038 (Stop Trading on Congressional Knowledge Act of 2012)",60,39,1,0,100
383677,216568,2012-02-02,Senate,"On the Amendment S.Amdt. 1488 to S.Amdt. 1470 to S. 2038 (Stop Trading on Congressional Knowledge Act of 2012)",24,75,1,0,100
383677,216569,2012-02-02,Senate,"On the Amendment S.Amdt. 1493 to S.Amdt. 1470 to S. 2038 (Stop Trading on Congressional Knowledge Act of 2012)",60,39,1,0,100
383677,216570,2012-02-02,Senate,"On the Amendment S.Amdt. 1481 to S.Amdt. 1470 to S. 2038 (Stop Trading on Congressional Knowledge Act of 2012)",26,73,1,0,100
383677,216571,2012-02-02,Senate,"On Passage of the Bill S. 2038",96,3,1,0,100
383677,216572,2012-03-22,Senate,"On the Cloture Motion S. 2038",96,3,1,0,100
383677,221010,2012-02-09,House,"On Motion to Suspend the Rules and Pass, as Amended",417,2,14,0,433
385387,216493,2012-09-12,House,"On Motion to Suspend the Rules and Pass, as Amended",355,62,12,0,429
385387,220762,2012-09-12,House,"On Motion to Suspend the Rules and Pass, as Amended",355,62,12,0,429
386892,217065,2012-02-02,House,"On Ordering the Previous Question",238,177,17,0,432
386892,217066,2012-02-02,House,"On Agreeing to the Resolution",238,179,15,0,432
386892,219507,2012-02-02,House,"On Ordering the Previous Question",238,177,17,0,432
386892,219508,2012-02-02,House,"On Agreeing to the Resolution",238,179,15,0,432
387014,216104,2012-05-15,House,"On Motion to Suspend the Rules and Pass, as Amended",400,1,30,0,431
387014,219571,2012-05-15,House,"On Motion to Suspend the Rules and Pass, as Amended",400,1,30,0,431
389620,217026,2012-02-06,House,"On Agreeing to the Resolution",233,155,44,0,432
389620,219360,2012-02-06,House,"On Agreeing to the Resolution",233,155,44,0,432
390659,216492,2012-02-07,House,"On Agreeing to the Resolution",239,181,13,0,433
390659,220726,2012-02-07,House,"On Agreeing to the Resolution",239,181,13,0,433
391792,216896,2012-02-08,House,"On Ordering the Previous Question",240,184,9,0,433
391792,216897,2012-02-08,House,"On Agreeing to the Resolution",238,175,20,0,433
391792,218890,2012-02-08,House,"On Ordering the Previous Question",240,184,9,0,433
391792,218891,2012-02-08,House,"On Agreeing to the Resolution",238,175,20,0,433
395999,216223,2012-03-19,House,"On Motion to Suspend the Rules and Pass",371,0,61,0,432
395999,219992,2012-03-19,House,"On Motion to Suspend the Rules and Pass",371,0,61,0,432
396180,216909,2012-06-28,House,"On Motion to Suspend the Rules and Pass, as Amended",411,9,12,0,432
396180,218935,2012-06-28,House,"On Motion to Suspend the Rules and Pass, as Amended",411,9,12,0,432
398626,217001,2012-02-15,House,"On Ordering the Previous Question",229,181,23,0,433
398626,217002,2012-02-15,House,"On Agreeing to the Resolution",235,186,12,0,433
398626,219211,2012-02-15,House,"On Ordering the Previous Question",229,181,23,0,433
398626,219212,2012-02-15,House,"On Agreeing to the Resolution",235,186,12,0,433
399474,216543,2012-04-16,House,"On Motion to Suspend the Rules and Pass",373,4,54,0,431
399474,220961,2012-04-16,House,"On Motion to Suspend the Rules and Pass",373,4,54,0,431
401414,216467,2012-12-13,House,"On Motion to Suspend the Rules and Pass, as Amended",402,0,29,0,431
401414,220647,2012-12-13,House,"On Motion to Suspend the Rules and Pass, as Amended",402,0,29,0,431
401440,216576,2012-12-30,House,"On Motion to Suspend the Rules and Concur in the Senate Amendment",392,3,36,0,431
401440,221019,2012-12-30,House,"On Motion to Suspend the Rules and Concur in the Senate Amendment",392,3,36,0,431
401543,216926,2012-03-01,House,"On Motion to Suspend the Rules and Agree, as Amended",417,1,15,0,433
401543,218975,2012-03-01,House,"On Motion to Suspend the Rules and Agree, as Amended",417,1,15,0,433
403252,216942,2012-07-25,House,"On Agreeing to the Amendment",188,231,12,0,431
403252,216943,2012-07-25,House,"On Agreeing to the Amendment",159,259,13,0,431
403252,216944,2012-07-25,House,"On Agreeing to the Amendment",173,245,13,0,431
403252,216945,2012-07-25,House,"On Agreeing to the Amendment",174,242,15,0,431
403252,216946,2012-07-25,House,"On Agreeing to the Amendment",177,240,14,0,431
403252,216947,2012-07-26,House,"On Agreeing to the Amendment",177,244,10,0,431
403252,216948,2012-07-26,House,"On Agreeing to the Amendment",177,238,16,0,431
403252,216949,2012-07-26,House,"On Agreeing to the Amendment",170,247,14,0,431
403252,216950,2012-07-26,House,"On Agreeing to the Amendment",173,246,12,0,431
403252,216951,2012-07-26,House,"On Agreeing to the Amendment",179,234,18,0,431
403252,216952,2012-07-26,House,"On Agreeing to the Amendment",248,171,12,0,431
403252,216953,2012-07-26,House,"On Agreeing to the Amendment",176,243,12,0,431
403252,216954,2012-07-26,House,"On Agreeing to the Amendment",240,178,13,0,431
403252,216955,2012-07-26,House,"On Agreeing to the Amendment",174,239,18,0,431
403252,216956,2012-07-26,House,"On Agreeing to the Amendment",178,236,17,0,431
403252,216957,2012-07-26,House,"On Agreeing to the Amendment",171,247,13,0,431
403252,216958,2012-07-26,House,"On Agreeing to the Amendment",251,166,14,0,431
403252,216959,2012-07-26,House,"On Agreeing to the Amendment",245,171,15,0,431
403252,216960,2012-07-26,House,"On Agreeing to the Amendment",173,243,15,0,431
403252,216961,2012-07-26,House,"On Agreeing to the Amendment",251,165,15,0,431
403252,216962,2012-07-26,House,"On Motion to Recommit with Instructions",181,234,16,0,431
403252,216963,2012-07-26,House,"On Passage",245,172,14,0,431
403252,219028,2012-07-25,House,"On Agreeing to the Amendment",188,231,12,0,431
403252,219029,2012-07-25,House,"On Agreeing to the Amendment",159,259,13,0,431
403252,219030,2012-07-25,House,"On Agreeing to the Amendment",173,245,13,0,431
403252,219031,2012-07-25,House,"On Agreeing to the Amendment",174,242,15,0,431
403252,219032,2012-07-25,House,"On Agreeing to the Amendment",177,240,14,0,431
403252,219033,2012-07-26,House,"On Agreeing to the Amendment",177,244,10,0,431
403252,219034,2012-07-26,House,"On Agreeing to the Amendment",177,238,16,0,431
403252,219035,2012-07-26,House,"On Agreeing to the Amendment",170,247,14,0,431
403252,219036,2012-07-26,House,"On Agreeing to the Amendment",173,246,12,0,431
403252,219037,2012-07-26,House,"On Agreeing to the Amendment",179,234,18,0,431
403252,219038,2012-07-26,House,"On Agreeing to the Amendment",248,171,12,0,431
403252,219039,2012-07-26,House,"On Agreeing to the Amendment",176,243,12,0,431
403252,219040,2012-07-26,House,"On Agreeing to the Amendment",240,178,13,0,431
403252,219041,2012-07-26,House,"On Agreeing to the Amendment",174,239,18,0,431
403252,219042,2012-07-26,House,"On Agreeing to the Amendment",178,236,17,0,431
403252,219043,2012-07-26,House,"On Agreeing to the Amendment",171,247,13,0,431
403252,219044,2012-07-26,House,"On Agreeing to the Amendment",251,166,14,0,431
403252,219045,2012-07-26,House,"On Agreeing to the Amendment",245,171,15,0,431
403252,219046,2012-07-26,House,"On Agreeing to the Amendment",173,243,15,0,431
403252,219047,2012-07-26,House,"On Agreeing to the Amendment",251,165,15,0,431
403252,219048,2012-07-26,House,"On Motion to Recommit with Instructions",181,234,16,0,431
403252,219049,2012-07-26,House,"On Passage",245,172,14,0,431
403539,216720,2012-04-24,Senate,"On the Motion to Proceed S.J.Res. 36",45,54,1,0,100
403558,216746,2012-06-20,Senate,"On the Motion to Proceed S.J.Res. 37",46,53,1,0,100
407737,216637,2012-02-28,House,"On Agreeing to the Resolution",244,171,18,0,433
407737,221190,2012-02-28,House,"On Agreeing to the Resolution",244,171,18,0,433
407760,216111,2012-03-01,House,"On Agreeing to the Resolution",418,0,15,0,433
407760,219592,2012-03-01,House,"On Agreeing to the Resolution",418,0,15,0,433
407854,216721,2012-04-17,House,"On Agreeing to the Amendment",152,260,19,0,431
407854,216722,2012-04-17,House,"On Agreeing to the Amendment",138,279,14,0,431
407854,216723,2012-04-17,House,"On Agreeing to the Amendment",155,262,14,0,431
407854,216724,2012-04-17,House,"On Agreeing to the Amendment",176,244,11,0,431
407854,216725,2012-04-17,House,"On Agreeing to the Amendment",223,198,10,0,431
407854,216726,2012-04-17,House,"On Motion to Recommit with Instructions",160,261,10,0,431
407854,216727,2012-04-17,House,"On Passage",274,146,11,0,431
407854,221250,2012-04-17,House,"On Agreeing to the Amendment",152,260,19,0,431
407854,221251,2012-04-17,House,"On Agreeing to the Amendment",138,279,14,0,431
407854,221252,2012-04-17,House,"On Agreeing to the Amendment",155,262,14,0,431
407854,221253,2012-04-17,House,"On Agreeing to the Amendment",176,244,11,0,431
407854,221254,2012-04-17,House,"On Agreeing to the Amendment",223,198,10,0,431
407854,221255,2012-04-17,House,"On Motion to Recommit with Instructions",160,261,10,0,431
407854,221256,2012-04-17,House,"On Passage",274,146,11,0,431
408440,216907,2012-02-29,House,"On Ordering the Previous Question",241,178,14,0,433
408440,216908,2012-02-29,House,"On Agreeing to the Resolution",245,173,15,0,433
408440,218930,2012-02-29,House,"On Ordering the Previous Question",241,178,14,0,433
408440,218931,2012-02-29,House,"On Agreeing to the Resolution",245,173,15,0,433
408453,216776,2012-05-07,House,"On Motion to Suspend the Rules and Agree",376,0,55,0,431
408453,221443,2012-05-07,House,"On Motion to Suspend the Rules and Agree",376,0,55,0,431
410245,216577,2012-05-17,House,"On Motion to Suspend the Rules and Agree, as Amended",401,11,19,0,431
410245,221022,2012-05-17,House,"On Motion to Suspend the Rules and Agree, as Amended",401,11,19,0,431
410346,216255,2012-05-16,House,"On Motion to Suspend the Rules and Pass, as Amended",416,4,11,0,431
410346,220063,2012-05-16,House,"On Motion to Suspend the Rules and Pass, as Amended",416,4,11,0,431
410418,217069,2012-03-06,House,"On Motion to Suspend the Rules and Pass",370,39,24,0,433
410418,219552,2012-03-06,House,"On Motion to Suspend the Rules and Pass",370,39,24,0,433
411379,216845,2012-05-09,House,"On Motion to Suspend the Rules and Pass, as Amended",411,2,18,0,431
411379,218795,2012-05-09,House,"On Motion to Suspend the Rules and Pass, as Amended",411,2,18,0,431
411505,216458,2012-03-06,House,"On Ordering the Previous Question",232,177,24,0,433
411505,222100,2012-03-06,House,"On Ordering the Previous Question",232,177,24,0,433
411995,216837,2012-03-07,House,"On Ordering the Previous Question",244,177,11,0,432
411995,216838,2012-03-07,House,"On Agreeing to the Resolution",252,166,14,0,432
411995,218737,2012-03-07,House,"On Ordering the Previous Question",244,177,11,0,432
411995,218738,2012-03-07,House,"On Agreeing to the Resolution",252,166,14,0,432
412383,216262,2012-07-09,House,"On Motion to Suspend the Rules and Pass, as Amended",369,0,62,0,431
412383,220080,2012-07-09,House,"On Motion to Suspend the Rules and Pass, as Amended",369,0,62,0,431
416157,216779,2012-05-30,House,"On Motion to Suspend the Rules and Pass",390,2,39,0,431
416157,221504,2012-05-30,House,"On Motion to Suspend the Rules and Pass",390,2,39,0,431
416348,216425,2012-03-20,House,"On Consideration of the Resolution",227,172,32,0,431
416348,216426,2012-03-20,House,"On Agreeing to the Resolution",232,170,29,0,431
416348,220534,2012-03-20,House,"On Consideration of the Resolution",227,172,32,0,431
416348,220535,2012-03-20,House,"On Agreeing to the Resolution",232,170,29,0,431
416360,220322,2013-01-01,House,"On Motion to Suspend the Rules and Concur in the Senate Amendment",378,37,16,0,431
416845,216821,2012-03-21,House,"On Ordering the Previous Question",231,179,21,0,431
416845,216822,2012-03-21,House,"On Agreeing to the Resolution",233,182,16,0,431
416845,218575,2012-03-21,House,"On Ordering the Previous Question",231,179,21,0,431
416845,218576,2012-03-21,House,"On Agreeing to the Resolution",233,182,16,0,431
417133,216830,2012-04-19,House,"On Agreeing to the Amendment",175,236,20,0,431
417133,216831,2012-04-19,House,"On Motion to Recommit with Instructions",179,229,23,0,431
417133,216832,2012-04-19,House,"On Passage",235,173,23,0,431
417133,218705,2012-04-19,House,"On Agreeing to the Amendment",175,236,20,0,431
417133,218706,2012-04-19,House,"On Motion to Recommit with Instructions",179,229,23,0,431
417133,218707,2012-04-19,House,"On Passage",235,173,23,0,431
417270,216978,2012-03-26,Senate,"On the Cloture Motion S. 2204",92,4,4,0,100
417270,216979,2012-03-27,Senate,"On the Cloture Motion S. 2204",51,47,2,0,100
417849,216895,2012-06-28,House,"On Motion to Suspend the Rules and Pass, as Amended",402,21,9,0,432
417849,218883,2012-06-28,House,"On Motion to Suspend the Rules and Pass, as Amended",402,21,9,0,432
417860,216128,2012-03-28,House,"On Agreeing to the Amendment",0,414,17,0,431
417860,216129,2012-03-28,House,"On Agreeing to the Amendment",107,314,10,0,431
417860,216130,2012-03-28,House,"On Agreeing to the Amendment",38,382,11,0,431
417860,216131,2012-03-29,House,"On Agreeing to the Amendment",78,346,7,0,431
417860,216132,2012-03-29,House,"On Agreeing to the Amendment",136,285,10,0,431
417860,216133,2012-03-29,House,"On Agreeing to the Amendment",163,262,6,0,431
417860,216134,2012-03-29,House,"On Agreeing to the Resolution",228,191,12,0,431
417860,216135,2012-05-16,Senate,"On the Motion to Proceed H.Con.Res. 112",41,58,1,0,100
417860,219642,2012-03-28,House,"On Agreeing to the Amendment",0,414,17,0,431
417860,219643,2012-03-28,House,"On Agreeing to the Amendment",107,314,10,0,431
417860,219644,2012-03-28,House,"On Agreeing to the Amendment",38,382,11,0,431
417860,219645,2012-03-29,House,"On Agreeing to the Amendment",78,346,7,0,431
417860,219646,2012-03-29,House,"On Agreeing to the Amendment",136,285,10,0,431
417860,219647,2012-03-29,House,"On Agreeing to the Amendment",163,262,6,0,431
417860,219648,2012-03-29,House,"On Agreeing to the Resolution",228,191,12,0,431
418119,216709,2012-03-27,House,"On Ordering the Previous Question",236,182,13,0,431
418119,216710,2012-03-27,House,"On Agreeing to the Resolution",242,177,12,0,431
418119,221238,2012-03-27,House,"On Ordering the Previous Question",236,182,13,0,431
418119,221239,2012-03-27,House,"On Agreeing to the Resolution",242,177,12,0,431
418519,216923,2012-03-28,House,"On Ordering the Previous Question",235,183,13,0,431
418519,216924,2012-03-28,House,"On Agreeing to the Resolution",241,184,6,0,431
418519,218972,2012-03-28,House,"On Ordering the Previous Question",235,183,13,0,431
418519,218973,2012-03-28,House,"On Agreeing to the Resolution",241,184,6,0,431
418726,216027,2012-09-11,House,"On Motion to Suspend the Rules and Pass, as Amended",402,7,20,0,429
418726,219243,2012-09-11,House,"On Motion to Suspend the Rules and Pass, as Amended",402,7,20,0,429
418773,216252,2012-03-29,House,"On Passage",266,158,7,0,431
418773,220043,2012-03-29,House,"On Passage",266,158,7,0,431
418779,216306,2012-03-29,House,"On Ordering the Previous Question",237,178,16,0,431
418779,220235,2012-03-29,House,"On Ordering the Previous Question",237,178,16,0,431
418796,216809,2012-04-16,Senate,"On Cloture on the Motion to Proceed S. 2230",51,45,4,0,100
418814,216795,2012-07-10,Senate,"On Cloture on the Motion to Proceed S. 2237",80,14,6,0,100
418814,216796,2012-07-12,Senate,"On the Motion to Table S.Amdt. 2524 to S. 2237 (Small Business Jobs and Tax Relief Act)",73,24,3,0,100
418814,216797,2012-07-12,Senate,"On the Cloture Motion S.Amdt. 2521 to S. 2237 (Small Business Jobs and Tax Relief Act)",57,41,2,0,100
418814,216798,2012-07-12,Senate,"On the Cloture Motion S. 2237",53,44,3,0,100
419804,216330,2012-05-17,House,"On Agreeing to the Amendment",84,335,12,0,431
419804,216331,2012-05-17,House,"On Agreeing to the Amendment",113,303,15,0,431
419804,216332,2012-05-17,House,"On Agreeing to the Amendment",412,1,18,0,431
419804,216333,2012-05-17,House,"On Agreeing to the Amendment",249,171,11,0,431
419804,216334,2012-05-17,House,"On Agreeing to the Amendment",211,209,11,0,431
419804,216335,2012-05-17,House,"On Agreeing to the Amendment",112,308,11,0,431
419804,216336,2012-05-17,House,"On Agreeing to the Amendment",165,252,14,0,431
419804,216337,2012-05-18,House,"On Agreeing to the Amendment",182,238,11,0,431
419804,216338,2012-05-18,House,"On Agreeing to the Amendment",243,173,15,0,431
419804,216339,2012-05-18,House,"On Agreeing to the Amendment",209,211,11,0,431
419804,216340,2012-05-18,House,"On Agreeing to the Amendment",192,229,10,0,431
419804,216341,2012-05-18,House,"On Agreeing to the Amendment",164,256,11,0,431
419804,216342,2012-05-18,House,"On Agreeing to the Amendment",180,241,10,0,431
419804,216343,2012-05-18,House,"On Agreeing to the Amendment",394,27,10,0,431
419804,216344,2012-05-18,House,"On Agreeing to the Amendment",118,303,10,0,431
419804,216345,2012-05-18,House,"On Agreeing to the Amendment",160,261,10,0,431
419804,216346,2012-05-18,House,"On Agreeing to the Amendment",175,245,11,0,431
419804,216347,2012-05-18,House,"On Agreeing to the Amendment",241,179,11,0,431
419804,216348,2012-05-18,House,"On Agreeing to the Amendment",220,201,10,0,431
419804,216349,2012-05-18,House,"On Agreeing to the Amendment",170,252,9,0,431
419804,216350,2012-05-18,House,"On Agreeing to the Amendment",229,193,9,0,431
419804,216351,2012-05-18,House,"On Agreeing to the Amendment",226,196,9,0,431
419804,216352,2012-05-18,House,"On Agreeing to the Amendment",77,344,10,0,431
419804,216353,2012-05-18,House,"On Agreeing to the Amendment",241,181,9,0,431
419804,216354,2012-05-18,House,"On Agreeing to the Amendment",121,300,10,0,431
419804,216355,2012-05-18,House,"On Agreeing to the Amendment",238,162,31,0,431
419804,216356,2012-05-18,House,"On Agreeing to the Amendment",379,38,14,0,431
419804,216357,2012-05-18,House,"On Motion to Recommit with Instructions",182,236,13,0,431
419804,216358,2012-05-18,House,"On Passage",299,120,12,0,431
419804,216359,2012-12-13,House,"On Motion to Instruct Conferees",399,4,28,0,431
419804,216360,2012-12-13,House,"On Motion to Permit Closed Conference Meetings",351,53,27,0,431
419804,216361,2012-12-20,House,"On Agreeing to the Conference Report",315,107,9,0,431
419804,216362,2012-12-21,Senate,"On the Conference Report H.R. 4310",81,14,4,0,99
419804,220336,2012-05-17,House,"On Agreeing to the Amendment",84,335,12,0,431
419804,220337,2012-05-17,House,"On Agreeing to the Amendment",113,303,15,0,431
419804,220338,2012-05-17,House,"On Agreeing to the Amendment",412,1,18,0,431
419804,220339,2012-05-17,House,"On Agreeing to the Amendment",249,171,11,0,431
419804,220340,2012-05-17,House,"On Agreeing to the Amendment",211,209,11,0,431
419804,220341,2012-05-17,House,"On Agreeing to the Amendment",112,308,11,0,431
419804,220342,2012-05-17,House,"On Agreeing to the Amendment",165,252,14,0,431
419804,220343,2012-05-18,House,"On Agreeing to the Amendment",182,238,11,0,431
419804,220344,2012-05-18,House,"On Agreeing to the Amendment",243,173,15,0,431
419804,220345,2012-05-18,House,"On Agreeing to the Amendment",209,211,11,0,431
419804,220346,2012-05-18,House,"On Agreeing to the Amendment",192,229,10,0,431
419804,220347,2012-05-18,House,"On Agreeing to the Amendment",164,256,11,0,431
419804,220348,2012-05-18,House,"On Agreeing to the Amendment",180,241,10,0,431
419804,220349,2012-05-18,House,"On Agreeing to the Amendment",394,27,10,0,431
419804,220350,2012-05-18,House,"On Agreeing to the Amendment",118,303,10,0,431
419804,220351,2012-05-18,House,"On Agreeing to the Amendment",160,261,10,0,431
419804,220352,2012-05-18,House,"On Agreeing to the Amendment",175,245,11,0,431
419804,220353,2012-05-18,House,"On Agreeing to the Amendment",241,179,11,0,431
419804,220354,2012-05-18,House,"On Agreeing to the Amendment",220,201,10,0,431
419804,220355,2012-05-18,House,"On Agreeing to the Amendment",170,252,9,0,431
419804,220356,2012-05-18,House,"On Agreeing to the Amendment",229,193,9,0,431
419804,220357,2012-05-18,House,"On Agreeing to the Amendment",226,196,9,0,431
419804,220358,2012-05-18,House,"On Agreeing to the Amendment",77,344,10,0,431
419804,220359,2012-05-18,House,"On Agreeing to the Amendment",241,181,9,0,431
419804,220360,2012-05-18,House,"On Agreeing to the Amendment",121,300,10,0,431
419804,220361,2012-05-18,House,"On Agreeing to the Amendment",238,162,31,0,431
419804,220362,2012-05-18,House,"On Agreeing to the Amendment",379,38,14,0,431
419804,220363,2012-05-18,House,"On Motion to Recommit with Instructions",182,236,13,0,431
419804,220364,2012-05-18,House,"On Passage",299,120,12,0,431
419804,220365,2012-12-13,House,"On Motion to Instruct Conferees",399,4,28,0,431
419804,220366,2012-12-13,House,"On Motion to Permit Closed Conference Meetings",351,53,27,0,431
419804,220367,2012-12-20,House,"On Agreeing to the Conference Report",315,107,9,0,431
420168,216127,2012-05-16,Senate,"On the Motion to Proceed S.Con.Res. 37",42,57,1,0,100
420993,216368,2012-04-18,House,"On Agreeing to the Amendment",255,165,11,0,431
420993,216369,2012-04-18,House,"On Motion to Recommit with Instructions",176,242,13,0,431
420993,216370,2012-04-18,House,"On Passage",293,127,11,0,431
420993,216371,2012-04-25,House,"On Motion to Instruct Conferees",181,242,8,0,431
420993,216372,2012-05-17,House,"On Barrow Motion to Instruct Conferees",261,152,18,0,431
420993,216373,2012-05-18,House,"On Rahall Motion to Instruct Conferees",245,169,17,0,431
420993,216374,2012-06-06,House,"On Flake Motion to Instruct Conferees",259,154,18,0,431
420993,216375,2012-06-06,House,"On Doggett Motion to Instruct Conferees",192,226,13,0,431
420993,216376,2012-06-07,House,"On Broun of Georgia Motion to Instruct Conferees",82,323,26,0,431
420993,216377,2012-06-19,House,"On Walz of Minnesota Motion to Instruct Conferees",386,34,12,0,432
420993,216378,2012-06-21,House,"On McKinley of West Virginia Motion to Instruct Conferees",260,138,34,0,432
420993,216379,2012-06-21,House,"On Hoyer of Maryland Motion to Instruct Conferees",172,225,35,0,432
420993,216380,2012-06-26,House,"On Black of Tennessee Motion to Instruct Conferees",201,194,37,0,432
420993,216381,2012-06-29,House,"On Agreeing to the Conference Report",373,52,7,0,432
420993,216382,2012-06-29,Senate,"On the Motion (Motion to Waive Paragraph 9 of Rule 28)",72,22,6,0,100
420993,216383,2012-06-29,Senate,"On the Motion (Motion to Waive Paragraph 3 of Rule 28)",66,28,6,0,100
420993,216384,2012-06-29,Senate,"On the Motion (Motion to Waive All Applicable Budgetary Discipline)",63,30,7,0,100
420993,216385,2012-06-29,Senate,"On the Conference Report H.R. 4348",74,19,7,0,100
420993,220434,2012-04-18,House,"On Agreeing to the Amendment",255,165,11,0,431
420993,220435,2012-04-18,House,"On Motion to Recommit with Instructions",176,242,13,0,431
420993,220436,2012-04-18,House,"On Passage",293,127,11,0,431
420993,220437,2012-04-25,House,"On Motion to Instruct Conferees",181,242,8,0,431
420993,220438,2012-05-17,House,"On Barrow Motion to Instruct Conferees",261,152,18,0,431
420993,220439,2012-05-18,House,"On Rahall Motion to Instruct Conferees",245,169,17,0,431
420993,220440,2012-06-06,House,"On Flake Motion to Instruct Conferees",259,154,18,0,431
420993,220441,2012-06-06,House,"On Doggett Motion to Instruct Conferees",192,226,13,0,431
420993,220442,2012-06-07,House,"On Broun of Georgia Motion to Instruct Conferees",82,323,26,0,431
420993,220443,2012-06-19,House,"On Walz of Minnesota Motion to Instruct Conferees",386,34,12,0,432
420993,220444,2012-06-21,House,"On McKinley of West Virginia Motion to Instruct Conferees",260,138,34,0,432
420993,220445,2012-06-21,House,"On Hoyer of Maryland Motion to Instruct Conferees",172,225,35,0,432
420993,220446,2012-06-26,House,"On Black of Tennessee Motion to Instruct Conferees",201,194,37,0,432
420993,220447,2012-06-29,House,"On Agreeing to the Conference Report",373,52,7,0,432
421012,216706,2012-04-17,House,"On Question of Consideration of the Resolution",234,175,22,0,431
421012,216707,2012-04-17,House,"On Ordering the Previous Question",235,179,17,0,431
421012,216708,2012-04-17,House,"On Agreeing to the Resolution",228,184,19,0,431
421012,221235,2012-04-17,House,"On Question of Consideration of the Resolution",234,175,22,0,431
421012,221236,2012-04-17,House,"On Ordering the Previous Question",235,179,17,0,431
421012,221237,2012-04-17,House,"On Agreeing to the Resolution",228,184,19,0,431
421197,216125,2012-05-16,Senate,"On the Motion to Proceed S.Con.Res. 41",0,99,1,0,100
421210,216787,2012-04-19,House,"On Ordering the Previous Question",234,179,18,0,431
421210,216788,2012-04-19,House,"On Agreeing to the Resolution, as Amended",234,178,19,0,431
421210,221579,2012-04-19,House,"On Ordering the Previous Question",234,179,18,0,431
421210,221580,2012-04-19,House,"On Agreeing to the Resolution, as Amended",234,178,19,0,431
421214,216678,2012-04-18,House,"On Ordering the Previous Question",243,180,8,0,431
421214,216679,2012-04-18,House,"On Agreeing to the Resolution",246,177,8,0,431
421214,221217,2012-04-18,House,"On Ordering the Previous Question",243,180,8,0,431
421214,221218,2012-04-18,House,"On Agreeing to the Resolution",246,177,8,0,431
421445,216675,2012-08-01,House,"On Motion to Suspend the Rules and Pass, as Amended",414,6,10,0,430
421445,221215,2012-08-01,House,"On Motion to Suspend the Rules and Pass, as Amended",414,6,10,0,430
421454,216805,2012-07-09,House,"On Motion to Suspend the Rules and Pass",371,0,60,0,431
421454,221688,2012-07-09,House,"On Motion to Suspend the Rules and Pass",371,0,60,0,431
421769,216846,2012-05-07,House,"On Motion to Suspend the Rules and Agree",377,0,54,0,431
421769,218797,2012-05-07,House,"On Motion to Suspend the Rules and Agree",377,0,54,0,431
422122,216747,2012-07-12,House,"On Agreeing to the Amendment",162,251,18,0,431
422122,216748,2012-07-12,House,"On Agreeing to the Amendment",162,252,17,0,431
422122,216749,2012-07-12,House,"On Agreeing to the Amendment",163,253,15,0,431
422122,216750,2012-07-12,House,"On Agreeing to the Amendment",238,178,15,0,431
422122,216751,2012-07-12,House,"On Agreeing to the Amendment",167,248,16,0,431
422122,216752,2012-07-12,House,"On Motion to Recommit with Instructions",181,231,19,0,431
422122,216753,2012-07-12,House,"On Passage",256,160,15,0,431
422122,221259,2012-07-12,House,"On Agreeing to the Amendment",162,251,18,0,431
422122,221260,2012-07-12,House,"On Agreeing to the Amendment",162,252,17,0,431
422122,221261,2012-07-12,House,"On Agreeing to the Amendment",163,253,15,0,431
422122,221262,2012-07-12,House,"On Agreeing to the Amendment",238,178,15,0,431
422122,221263,2012-07-12,House,"On Agreeing to the Amendment",167,248,16,0,431
422122,221264,2012-07-12,House,"On Motion to Recommit with Instructions",181,231,19,0,431
422122,221265,2012-07-12,House,"On Passage",256,160,15,0,431
422642,217030,2012-04-27,House,"On Motion to Recommit with Instructions",178,231,22,0,431
422642,217031,2012-04-27,House,"On Passage",215,195,22,0,432
422642,219392,2012-04-27,House,"On Motion to Recommit with Instructions",178,231,22,0,431
422642,219393,2012-04-27,House,"On Passage",215,195,22,0,432
422644,216860,2012-05-07,House,"On Motion to Suspend the Rules and Agree",375,0,56,0,431
422644,218829,2012-05-07,House,"On Motion to Suspend the Rules and Agree",375,0,56,0,431
422657,216814,2012-04-26,House,"On Ordering the Previous Question",241,179,11,0,431
422657,216815,2012-04-26,House,"On Agreeing to the Resolution",236,185,10,0,431
422657,218558,2012-04-26,House,"On Ordering the Previous Question",241,179,11,0,431
422657,218559,2012-04-26,House,"On Agreeing to the Resolution",236,185,10,0,431
422698,216981,2012-05-08,Senate,"On Cloture on the Motion to Proceed S. 2343",52,45,3,0,100
422698,216982,2012-05-24,Senate,"On the Amendment S.Amdt. 2153 to S. 2343 (Stop the Student Loan Interest Rate Hike Act of2012)",34,62,4,0,100
422698,216983,2012-05-24,Senate,"On Passage of the Bill S. 2343",51,43,6,0,100
422864,216387,2012-06-21,House,"On Agreeing to the Amendment",253,163,16,0,432
422864,216388,2012-06-21,House,"On Agreeing to the Amendment",164,249,19,0,432
422864,216389,2012-06-21,House,"On Agreeing to the Amendment",177,242,13,0,432
422864,216390,2012-06-21,House,"On Agreeing to the Amendment",174,244,14,0,432
422864,216391,2012-06-21,House,"On Agreeing to the Amendment",164,255,13,0,432
422864,216392,2012-06-21,House,"On Agreeing to the Amendment",164,256,12,0,432
422864,216393,2012-06-21,House,"On Agreeing to the Amendment",190,230,12,0,432
422864,216394,2012-06-21,House,"On Agreeing to the Amendment",257,162,13,0,432
422864,216395,2012-06-21,House,"On Agreeing to the Amendment",161,256,15,0,432
422864,216396,2012-06-21,House,"On Agreeing to the Amendment",244,173,15,0,432
422864,216397,2012-06-21,House,"On Agreeing to the Amendment",263,146,23,0,432
422864,216398,2012-06-21,House,"On Agreeing to the Amendment",168,250,14,0,432
422864,216399,2012-06-21,House,"On Agreeing to the Amendment",256,161,15,0,432
422864,216400,2012-06-21,House,"On Agreeing to the Amendment",186,233,13,0,432
422864,216401,2012-06-21,House,"On Agreeing to the Amendment",162,254,16,0,432
422864,216402,2012-06-21,House,"On Agreeing to the Amendment",162,255,15,0,432
422864,216403,2012-06-21,House,"On Agreeing to the Amendment",180,235,17,0,432
422864,216404,2012-06-21,House,"On Motion to Recommit with Instructions",166,243,23,0,432
422864,216405,2012-06-21,House,"On Passage",248,163,21,0,432
422864,220453,2012-06-21,House,"On Agreeing to the Amendment",253,163,16,0,432
422864,220454,2012-06-21,House,"On Agreeing to the Amendment",164,249,19,0,432
422864,220455,2012-06-21,House,"On Agreeing to the Amendment",177,242,13,0,432
422864,220456,2012-06-21,House,"On Agreeing to the Amendment",174,244,14,0,432
422864,220457,2012-06-21,House,"On Agreeing to the Amendment",164,255,13,0,432
422864,220458,2012-06-21,House,"On Agreeing to the Amendment",164,256,12,0,432
422864,220459,2012-06-21,House,"On Agreeing to the Amendment",190,230,12,0,432
422864,220460,2012-06-21,House,"On Agreeing to the Amendment",257,162,13,0,432
422864,220461,2012-06-21,House,"On Agreeing to the Amendment",161,256,15,0,432
422864,220462,2012-06-21,House,"On Agreeing to the Amendment",244,173,15,0,432
422864,220463,2012-06-21,House,"On Agreeing to the Amendment",263,146,23,0,432
422864,220464,2012-06-21,House,"On Agreeing to the Amendment",168,250,14,0,432
422864,220465,2012-06-21,House,"On Agreeing to the Amendment",256,161,15,0,432
422864,220466,2012-06-21,House,"On Agreeing to the Amendment",186,233,13,0,432
422864,220467,2012-06-21,House,"On Agreeing to the Amendment",162,254,16,0,432
422864,220468,2012-06-21,House,"On Agreeing to the Amendment",162,255,15,0,432
422864,220469,2012-06-21,House,"On Agreeing to the Amendment",180,235,17,0,432
422864,220470,2012-06-21,House,"On Motion to Recommit with Instructions",166,243,23,0,432
422864,220471,2012-06-21,House,"On Passage",248,163,21,0,432
423347,216966,2012-12-05,House,"On Motion to Suspend the Rules and Pass",398,1,32,0,431
423347,219073,2012-12-05,House,"On Motion to Suspend the Rules and Pass",398,1,32,0,431
423662,216263,2012-05-16,Senate,"On the Motion to Proceed S.Con.Res. 42",16,83,1,0,100
424151,216540,2012-05-16,House,"On Motion to Recommit with Instructions",187,236,8,0,431
424151,216541,2012-05-16,House,"On Passage",222,205,4,0,431
424151,220927,2012-05-16,House,"On Motion to Recommit with Instructions",187,236,8,0,431
424151,220928,2012-05-16,House,"On Passage",222,205,4,0,431
424160,216705,2012-09-19,House,"On Motion to Suspend the Rules and Pass, as Amended",400,0,29,0,429
424160,221228,2012-09-19,House,"On Motion to Suspend the Rules and Pass, as Amended",400,0,29,0,429
424182,216504,2012-06-01,House,"On Agreeing to the Amendment",216,177,38,0,431
424182,216505,2012-06-01,House,"On Agreeing to the Amendment",203,185,43,0,431
424182,216506,2012-06-01,House,"On Agreeing to the Amendment",152,237,42,0,431
424182,216507,2012-06-01,House,"On Agreeing to the Amendment",130,256,45,0,431
424182,216508,2012-06-01,House,"On Agreeing to the Amendment",140,245,46,0,431
424182,216509,2012-06-01,House,"On Agreeing to the Amendment",113,275,43,0,431
424182,216510,2012-06-01,House,"On Agreeing to the Amendment",183,200,48,0,431
424182,216511,2012-06-01,House,"On Agreeing to the Amendment",148,236,47,0,431
424182,216512,2012-06-01,House,"On Agreeing to the Amendment",139,245,47,0,431
424182,216513,2012-06-05,House,"On Agreeing to the Amendment",106,281,44,0,431
424182,216514,2012-06-05,House,"On Agreeing to the Amendment",131,257,43,0,431
424182,216515,2012-06-05,House,"On Agreeing to the Amendment",138,249,44,0,431
424182,216516,2012-06-05,House,"On Agreeing to the Amendment",152,235,44,0,431
424182,216517,2012-06-06,House,"On Agreeing to the Amendment",181,229,21,0,431
424182,216518,2012-06-06,House,"On Agreeing to the Amendment",348,60,23,0,431
424182,216519,2012-06-06,House,"On Agreeing to the Amendment",326,81,24,0,431
424182,216520,2012-06-06,House,"On Agreeing to the Amendment",355,51,25,0,431
424182,216521,2012-06-06,House,"On Agreeing to the Amendment",242,168,21,0,431
424182,216522,2012-06-06,House,"On Agreeing to the Amendment",150,260,21,0,431
424182,216523,2012-06-06,House,"On Agreeing to the Amendment",328,89,14,0,431
424182,216524,2012-06-06,House,"On Agreeing to the Amendment",157,260,14,0,431
424182,216525,2012-06-06,House,"On Agreeing to the Amendment",136,282,13,0,431
424182,216526,2012-06-06,House,"On Agreeing to the Amendment",168,249,14,0,431
424182,216527,2012-06-06,House,"On Agreeing to the Amendment",223,195,13,0,431
424182,216528,2012-06-06,House,"On Agreeing to the Amendment",182,237,12,0,431
424182,216529,2012-06-06,House,"On Agreeing to the Amendment",138,281,12,0,431
424182,216530,2012-06-06,House,"On Agreeing to the Amendment",174,244,13,0,431
424182,216531,2012-06-06,House,"On Agreeing to the Amendment",141,276,14,0,431
424182,216532,2012-06-06,House,"On Agreeing to the Amendment",157,261,13,0,431
424182,216533,2012-06-06,House,"On Agreeing to the Amendment",125,293,13,0,431
424182,216534,2012-06-06,House,"On Agreeing to the Amendment",144,274,13,0,431
424182,216535,2012-06-06,House,"On Agreeing to the Amendment",184,235,12,0,431
424182,216536,2012-06-06,House,"On Agreeing to the Amendment",114,302,15,0,431
424182,216537,2012-06-06,House,"On Agreeing to the Amendment",208,207,16,0,431
424182,216538,2012-06-06,House,"On Motion to Recommit with Instructions",185,233,13,0,431
424182,216539,2012-06-06,House,"On Passage",255,165,11,0,431
424182,220882,2012-06-01,House,"On Agreeing to the Amendment",216,177,38,0,431
424182,220883,2012-06-01,House,"On Agreeing to the Amendment",203,185,43,0,431
424182,220884,2012-06-01,House,"On Agreeing to the Amendment",152,237,42,0,431
424182,220885,2012-06-01,House,"On Agreeing to the Amendment",130,256,45,0,431
424182,220886,2012-06-01,House,"On Agreeing to the Amendment",140,245,46,0,431
424182,220887,2012-06-01,House,"On Agreeing to the Amendment",113,275,43,0,431
424182,220888,2012-06-01,House,"On Agreeing to the Amendment",183,200,48,0,431
424182,220889,2012-06-01,House,"On Agreeing to the Amendment",148,236,47,0,431
424182,220890,2012-06-01,House,"On Agreeing to the Amendment",139,245,47,0,431
424182,220891,2012-06-05,House,"On Agreeing to the Amendment",106,281,44,0,431
424182,220892,2012-06-05,House,"On Agreeing to the Amendment",131,257,43,0,431
424182,220893,2012-06-05,House,"On Agreeing to the Amendment",138,249,44,0,431
424182,220894,2012-06-05,House,"On Agreeing to the Amendment",152,235,44,0,431
424182,220895,2012-06-06,House,"On Agreeing to the Amendment",181,229,21,0,431
424182,220896,2012-06-06,House,"On Agreeing to the Amendment",348,60,23,0,431
424182,220897,2012-06-06,House,"On Agreeing to the Amendment",326,81,24,0,431
424182,220898,2012-06-06,House,"On Agreeing to the Amendment",355,51,25,0,431
424182,220899,2012-06-06,House,"On Agreeing to the Amendment",242,168,21,0,431
424182,220900,2012-06-06,House,"On Agreeing to the Amendment",150,260,21,0,431
424182,220901,2012-06-06,House,"On Agreeing to the Amendment",328,89,14,0,431
424182,220902,2012-06-06,House,"On Agreeing to the Amendment",157,260,14,0,431
424182,220903,2012-06-06,House,"On Agreeing to the Amendment",136,282,13,0,431
424182,220904,2012-06-06,House,"On Agreeing to the Amendment",168,249,14,0,431
424182,220905,2012-06-06,House,"On Agreeing to the Amendment",223,195,13,0,431
424182,220906,2012-06-06,House,"On Agreeing to the Amendment",182,237,12,0,431
424182,220907,2012-06-06,House,"On Agreeing to the Amendment",138,281,12,0,431
424182,220908,2012-06-06,House,"On Agreeing to the Amendment",174,244,13,0,431
424182,220909,2012-06-06,House,"On Agreeing to the Amendment",141,276,14,0,431
424182,220910,2012-06-06,House,"On Agreeing to the Amendment",157,261,13,0,431
424182,220911,2012-06-06,House,"On Agreeing to the Amendment",125,293,13,0,431
424182,220912,2012-06-06,House,"On Agreeing to the Amendment",144,274,13,0,431
424182,220913,2012-06-06,House,"On Agreeing to the Amendment",184,235,12,0,431
424182,220914,2012-06-06,House,"On Agreeing to the Amendment",114,302,15,0,431
424182,220915,2012-06-06,House,"On Agreeing to the Amendment",208,207,16,0,431
424182,220916,2012-06-06,House,"On Motion to Recommit with Instructions",185,233,13,0,431
424182,220917,2012-06-06,House,"On Passage",255,165,11,0,431
424183,216586,2012-05-08,House,"On Agreeing to the Amendment",141,261,29,0,431
424183,216587,2012-05-08,House,"On Agreeing to the Amendment",137,270,24,0,431
424183,216588,2012-05-08,House,"On Agreeing to the Amendment",121,287,23,0,431
424183,216589,2012-05-08,House,"On Agreeing to the Amendment",190,218,23,0,431
424183,216590,2012-05-08,House,"On Agreeing to the Amendment",174,233,24,0,431
424183,216591,2012-05-08,House,"On Agreeing to the Amendment",129,279,23,0,431
424183,216592,2012-05-08,House,"On Agreeing to the Amendment",147,259,25,0,431
424183,216593,2012-05-08,House,"On Agreeing to the Amendment",219,189,23,0,431
424183,216594,2012-05-08,House,"On Agreeing to the Amendment",209,199,23,0,431
424183,216595,2012-05-08,House,"On Agreeing to the Amendment",168,239,24,0,431
424183,216596,2012-05-08,House,"On Agreeing to the Amendment",325,81,25,0,431
424183,216597,2012-05-08,House,"On Agreeing to the Amendment",99,311,21,0,431
424183,216598,2012-05-08,House,"On Agreeing to the Amendment",206,204,21,0,431
424183,216599,2012-05-08,House,"On Agreeing to the Amendment",199,211,21,0,431
424183,216600,2012-05-09,House,"On Agreeing to the Amendment",96,314,21,0,431
424183,216601,2012-05-09,House,"On Agreeing to the Amendment",121,291,19,0,431
424183,216602,2012-05-09,House,"On Agreeing to the Amendment",165,246,20,0,431
424183,216603,2012-05-09,House,"On Agreeing to the Amendment",122,289,20,0,431
424183,216604,2012-05-09,House,"On Agreeing to the Amendment",238,173,20,0,431
424183,216605,2012-05-09,House,"On Agreeing to the Amendment",160,251,20,0,431
424183,216606,2012-05-09,House,"On Agreeing to the Amendment",105,307,19,0,431
424183,216607,2012-05-09,House,"On Agreeing to the Amendment",220,191,20,0,431
424183,216608,2012-05-09,House,"On Agreeing to the Amendment",381,41,9,0,431
424183,216609,2012-05-09,House,"On Agreeing to the Amendment",160,260,11,0,431
424183,216610,2012-05-09,House,"On Agreeing to the Amendment",229,194,8,0,431
424183,216611,2012-05-09,House,"On Agreeing to the Amendment",232,192,7,0,431
424183,216612,2012-05-09,House,"On Agreeing to the Amendment",238,185,8,0,431
424183,216613,2012-05-09,House,"On Agreeing to the Amendment",232,190,9,0,431
424183,216614,2012-05-09,House,"On Agreeing to the Amendment",232,190,9,0,431
424183,216615,2012-05-09,House,"On Agreeing to the Amendment",250,173,8,0,431
424183,216616,2012-05-09,House,"On Agreeing to the Amendment",246,174,11,0,431
424183,216617,2012-05-09,House,"On Agreeing to the Amendment",245,171,15,0,431
424183,216618,2012-05-09,House,"On Agreeing to the Amendment",218,201,12,0,431
424183,216619,2012-05-09,House,"On Agreeing to the Amendment",357,68,6,0,431
424183,216620,2012-05-09,House,"On Agreeing to the Amendment",163,262,6,0,431
424183,216621,2012-05-09,House,"On Agreeing to the Amendment",189,235,7,0,431
424183,216622,2012-05-09,House,"On Agreeing to the Amendment",193,232,6,0,431
424183,216623,2012-05-09,House,"On Agreeing to the Amendment",238,188,5,0,431
424183,216624,2012-05-09,House,"On Agreeing to the Amendment",209,217,5,0,431
424183,216625,2012-05-09,House,"On Agreeing to the Amendment",218,208,5,0,431
424183,216626,2012-05-10,House,"On Motion to Recommit with Instructions",181,233,17,0,431
424183,216627,2012-05-10,House,"On Passage",247,163,21,0,431
424183,221101,2012-05-08,House,"On Agreeing to the Amendment",141,261,29,0,431
424183,221102,2012-05-08,House,"On Agreeing to the Amendment",137,270,24,0,431
424183,221103,2012-05-08,House,"On Agreeing to the Amendment",121,287,23,0,431
424183,221104,2012-05-08,House,"On Agreeing to the Amendment",190,218,23,0,431
424183,221105,2012-05-08,House,"On Agreeing to the Amendment",174,233,24,0,431
424183,221106,2012-05-08,House,"On Agreeing to the Amendment",129,279,23,0,431
424183,221107,2012-05-08,House,"On Agreeing to the Amendment",147,259,25,0,431
424183,221108,2012-05-08,House,"On Agreeing to the Amendment",219,189,23,0,431
424183,221109,2012-05-08,House,"On Agreeing to the Amendment",209,199,23,0,431
424183,221110,2012-05-08,House,"On Agreeing to the Amendment",168,239,24,0,431
424183,221111,2012-05-08,House,"On Agreeing to the Amendment",325,81,25,0,431
424183,221112,2012-05-08,House,"On Agreeing to the Amendment",99,311,21,0,431
424183,221113,2012-05-08,House,"On Agreeing to the Amendment",206,204,21,0,431
424183,221114,2012-05-08,House,"On Agreeing to the Amendment",199,211,21,0,431
424183,221115,2012-05-09,House,"On Agreeing to the Amendment",96,314,21,0,431
424183,221116,2012-05-09,House,"On Agreeing to the Amendment",121,291,19,0,431
424183,221117,2012-05-09,House,"On Agreeing to the Amendment",165,246,20,0,431
424183,221118,2012-05-09,House,"On Agreeing to the Amendment",122,289,20,0,431
424183,221119,2012-05-09,House,"On Agreeing to the Amendment",238,173,20,0,431
424183,221120,2012-05-09,House,"On Agreeing to the Amendment",160,251,20,0,431
424183,221121,2012-05-09,House,"On Agreeing to the Amendment",105,307,19,0,431
424183,221122,2012-05-09,House,"On Agreeing to the Amendment",220,191,20,0,431
424183,221123,2012-05-09,House,"On Agreeing to the Amendment",381,41,9,0,431
424183,221124,2012-05-09,House,"On Agreeing to the Amendment",160,260,11,0,431
424183,221125,2012-05-09,House,"On Agreeing to the Amendment",229,194,8,0,431
424183,221126,2012-05-09,House,"On Agreeing to the Amendment",232,192,7,0,431
424183,221127,2012-05-09,House,"On Agreeing to the Amendment",238,185,8,0,431
424183,221128,2012-05-09,House,"On Agreeing to the Amendment",232,190,9,0,431
424183,221129,2012-05-09,House,"On Agreeing to the Amendment",232,190,9,0,431
424183,221130,2012-05-09,House,"On Agreeing to the Amendment",250,173,8,0,431
424183,221131,2012-05-09,House,"On Agreeing to the Amendment",246,174,11,0,431
424183,221132,2012-05-09,House,"On Agreeing to the Amendment",245,171,15,0,431
424183,221133,2012-05-09,House,"On Agreeing to the Amendment",218,201,12,0,431
424183,221134,2012-05-09,House,"On Agreeing to the Amendment",357,68,6,0,431
424183,221135,2012-05-09,House,"On Agreeing to the Amendment",163,262,6,0,431
424183,221136,2012-05-09,House,"On Agreeing to the Amendment",189,235,7,0,431
424183,221137,2012-05-09,House,"On Agreeing to the Amendment",193,232,6,0,431
424183,221138,2012-05-09,House,"On Agreeing to the Amendment",238,188,5,0,431
424183,221139,2012-05-09,House,"On Agreeing to the Amendment",209,217,5,0,431
424183,221140,2012-05-09,House,"On Agreeing to the Amendment",218,208,5,0,431
424183,221141,2012-05-10,House,"On Motion to Recommit with Instructions",181,233,17,0,431
424183,221142,2012-05-10,House,"On Passage",247,163,21,0,431
424757,217006,2012-05-08,House,"On Ordering the Previous Question",235,174,22,0,431
424757,217007,2012-05-08,House,"On Agreeing to the Resolution",228,181,22,0,431
424757,219222,2012-05-08,House,"On Ordering the Previous Question",235,174,22,0,431
424757,219223,2012-05-08,House,"On Agreeing to the Resolution",228,181,22,0,431
425260,217004,2012-05-10,House,"On Motion to Recommit with Instructions",170,232,29,0,431
425260,217005,2012-05-10,House,"On Passage",218,199,14,0,431
425260,219219,2012-05-10,House,"On Motion to Recommit with Instructions",170,232,29,0,431
425260,219220,2012-05-10,House,"On Passage",218,199,14,0,431
425263,216777,2012-05-10,House,"On Ordering the Previous Question",237,177,17,0,431
425263,216778,2012-05-10,House,"On Agreeing to the Resolution",233,183,15,0,431
425263,221470,2012-05-10,House,"On Ordering the Previous Question",237,177,17,0,431
425263,221471,2012-05-10,House,"On Agreeing to the Resolution",233,183,15,0,431
425279,216103,2012-05-16,Senate,"On the Motion to Proceed S.Con.Res. 44",17,82,1,0,100
426018,216202,2012-09-12,House,"On Agreeing to the Amendment",201,213,15,0,429
426018,216203,2012-09-12,House,"On Agreeing to the Amendment",177,236,16,0,429
426018,216204,2012-09-12,House,"On Agreeing to the Amendment",190,225,14,0,429
426018,216205,2012-09-12,House,"On Agreeing to the Amendment",191,223,15,0,429
426018,216206,2012-09-12,House,"On Motion to Recommit with Instructions",183,233,13,0,429
426018,216207,2012-09-12,House,"On Passage",225,189,15,0,429
426018,219881,2012-09-12,House,"On Agreeing to the Amendment",201,213,15,0,429
426018,219882,2012-09-12,House,"On Agreeing to the Amendment",177,236,16,0,429
426018,219883,2012-09-12,House,"On Agreeing to the Amendment",190,225,14,0,429
426018,219884,2012-09-12,House,"On Agreeing to the Amendment",191,223,15,0,429
426018,219885,2012-09-12,House,"On Motion to Recommit with Instructions",183,233,13,0,429
426018,219886,2012-09-12,House,"On Passage",225,189,15,0,429
426404,216575,2012-05-30,House,"On Motion to Suspend the Rules and Pass, as Amended",387,5,39,0,431
426404,221015,2012-05-30,House,"On Motion to Suspend the Rules and Pass, as Amended",387,5,39,0,431
426632,216253,2012-05-17,House,"On Motion to Suspend the Rules and Pass",402,18,11,0,431
426632,220045,2012-05-17,House,"On Motion to Suspend the Rules and Pass",402,18,11,0,431
426635,216055,2012-05-16,House,"On Question of Consideration of the Resolution",239,183,9,0,431
426635,216056,2012-05-16,House,"On Ordering the Previous Question",235,187,9,0,431
426635,216057,2012-05-16,House,"On Agreeing to the Resolution",235,186,10,0,431
426635,219558,2012-05-16,House,"On Question of Consideration of the Resolution",239,183,9,0,431
426635,219559,2012-05-16,House,"On Ordering the Previous Question",235,187,9,0,431
426635,219560,2012-05-16,House,"On Agreeing to the Resolution",235,186,10,0,431
427028,216920,2012-05-31,House,"On Motion to Recommit with Instructions",180,235,16,0,431
427028,216921,2012-05-31,House,"On Passage",386,28,17,0,431
427028,218965,2012-05-31,House,"On Motion to Recommit with Instructions",180,235,16,0,431
427028,218966,2012-05-31,House,"On Passage",386,28,17,0,431
427088,216309,2012-05-17,House,"On Ordering the Previous Question",236,182,13,0,431
427088,216310,2012-05-17,House,"On Agreeing to the Resolution",244,178,9,0,431
427088,220256,2012-05-17,House,"On Ordering the Previous Question",236,182,13,0,431
427088,220257,2012-05-17,House,"On Agreeing to the Resolution",244,178,9,0,431
427494,216544,2012-05-24,Senate,"On the Amendment S.Amdt. 2111 to S. 3187 (No short title on file)",28,67,5,0,100
427494,216545,2012-05-24,Senate,"On the Amendment S.Amdt. 2108 to S. 3187 (No short title on file)",46,50,4,0,100
427494,216546,2012-05-24,Senate,"On the Motion to Table S.Amdt. 2143 to S. 3187 (No short title on file)",78,15,7,0,100
427494,216547,2012-05-24,Senate,"On the Amendment S.Amdt. 2107 to S. 3187 (No short title on file)",43,54,3,0,100
427494,216548,2012-05-24,Senate,"On the Amendment S.Amdt. 2109 to S. 3187 (No short title on file)",9,88,3,0,100
427494,216549,2012-05-24,Senate,"On the Motion to Table S.Amdt. 2127 to S. 3187 (No short title on file)",77,20,3,0,100
427494,216550,2012-05-24,Senate,"On Passage of the Bill S. 3187",96,1,3,0,100
427494,216551,2012-06-21,Senate,"On the Cloture Motion S. 3187",89,3,8,0,100
427494,216552,2012-06-26,Senate,"On the Motion (Motion to Concur in the House Amendment to Accompany S. 3187)",92,4,4,0,100
427808,216500,2012-12-30,House,"On Motion to Suspend the Rules and Pass",393,0,38,0,431
427808,220838,2012-12-30,House,"On Motion to Suspend the Rules and Pass",393,0,38,0,431
427820,216363,2012-12-17,House,"On Motion to Suspend the Rules and Pass",306,0,125,0,431
427820,220373,2012-12-17,House,"On Motion to Suspend the Rules and Pass",306,0,125,0,431
428381,216436,2012-06-06,House,"On Agreeing to the Amendment",154,260,17,0,431
428381,216437,2012-06-06,House,"On Agreeing to the Amendment",140,273,18,0,431
428381,216438,2012-06-06,House,"On Agreeing to the Amendment",173,240,18,0,431
428381,216439,2012-06-06,House,"On Agreeing to the Amendment",211,202,18,0,431
428381,216440,2012-06-06,House,"On Agreeing to the Amendment",159,254,18,0,431
428381,216441,2012-06-06,House,"On Agreeing to the Amendment",156,261,14,0,431
428381,216442,2012-06-06,House,"On Agreeing to the Amendment",144,273,14,0,431
428381,216443,2012-06-06,House,"On Agreeing to the Amendment",302,113,16,0,431
428381,216444,2012-06-06,House,"On Agreeing to the Amendment",230,186,15,0,431
428381,216445,2012-06-06,House,"On Agreeing to the Amendment",167,249,15,0,431
428381,216446,2012-06-06,House,"On Agreeing to the Amendment",60,355,16,0,431
428381,216447,2012-06-06,House,"On Agreeing to the Amendment",150,266,15,0,431
428381,216448,2012-06-06,House,"On Agreeing to the Amendment",166,245,20,0,431
428381,216449,2012-06-07,House,"On Agreeing to the Amendment",224,189,18,0,431
428381,216450,2012-06-07,House,"On Agreeing to the Amendment",238,175,18,0,431
428381,216451,2012-06-07,House,"On Agreeing to the Amendment",131,282,18,0,431
428381,216452,2012-06-07,House,"On Agreeing to the Amendment",204,210,17,0,431
428381,216453,2012-06-07,House,"On Agreeing to the Amendment",250,164,17,0,431
428381,216454,2012-06-07,House,"On Agreeing to the Amendment",101,314,16,0,431
428381,216455,2012-06-07,House,"On Agreeing to the Amendment",99,316,16,0,431
428381,216456,2012-06-07,House,"On Motion to Recommit with Instructions",165,251,15,0,431
428381,216457,2012-06-07,House,"On Passage",234,182,15,0,431
428381,222074,2012-06-06,House,"On Agreeing to the Amendment",154,260,17,0,431
428381,222075,2012-06-06,House,"On Agreeing to the Amendment",140,273,18,0,431
428381,222076,2012-06-06,House,"On Agreeing to the Amendment",173,240,18,0,431
428381,222077,2012-06-06,House,"On Agreeing to the Amendment",211,202,18,0,431
428381,222078,2012-06-06,House,"On Agreeing to the Amendment",159,254,18,0,431
428381,222079,2012-06-06,House,"On Agreeing to the Amendment",156,261,14,0,431
428381,222080,2012-06-06,House,"On Agreeing to the Amendment",144,273,14,0,431
428381,222081,2012-06-06,House,"On Agreeing to the Amendment",302,113,16,0,431
428381,222082,2012-06-06,House,"On Agreeing to the Amendment",230,186,15,0,431
428381,222083,2012-06-06,House,"On Agreeing to the Amendment",167,249,15,0,431
428381,222084,2012-06-06,House,"On Agreeing to the Amendment",60,355,16,0,431
428381,222085,2012-06-06,House,"On Agreeing to the Amendment",150,266,15,0,431
428381,222086,2012-06-06,House,"On Agreeing to the Amendment",166,245,20,0,431
428381,222087,2012-06-07,House,"On Agreeing to the Amendment",224,189,18,0,431
428381,222088,2012-06-07,House,"On Agreeing to the Amendment",238,175,18,0,431
428381,222089,2012-06-07,House,"On Agreeing to the Amendment",131,282,18,0,431
428381,222090,2012-06-07,House,"On Agreeing to the Amendment",204,210,17,0,431
428381,222091,2012-06-07,House,"On Agreeing to the Amendment",250,164,17,0,431
428381,222092,2012-06-07,House,"On Agreeing to the Amendment",101,314,16,0,431
428381,222093,2012-06-07,House,"On Agreeing to the Amendment",99,316,16,0,431
428381,222094,2012-06-07,House,"On Motion to Recommit with Instructions",165,251,15,0,431
428381,222095,2012-06-07,House,"On Passage",234,182,15,0,431
428383,217009,2012-05-31,House,"On Agreeing to the Amendment",218,198,15,0,431
428383,217010,2012-05-31,House,"On Agreeing to the Amendment",180,237,14,0,431
428383,217011,2012-05-31,House,"On Motion to Recommit with Instructions",188,230,13,0,431
428383,217012,2012-05-31,House,"On Passage",407,12,12,0,431
428383,219275,2012-05-31,House,"On Agreeing to the Amendment",218,198,15,0,431
428383,219276,2012-05-31,House,"On Agreeing to the Amendment",180,237,14,0,431
428383,219277,2012-05-31,House,"On Motion to Recommit with Instructions",188,230,13,0,431
428383,219278,2012-05-31,House,"On Passage",407,12,12,0,431
428660,216922,2012-06-05,Senate,"On Cloture on the Motion to Proceed S. 3220",52,47,1,0,100
428779,216058,2012-06-07,Senate,"On Cloture on the Motion to Proceed S. 3240",90,8,2,0,100
428779,216059,2012-06-13,Senate,"On the Motion to Table S.Amdt. 2393 to S.Amdt. 2392 to S.Amdt. 2391 to S. 3240",50,46,4,0,100
428779,216060,2012-06-13,Senate,"On the Motion to Table S.Amdt. 2392 to S.Amdt. 2391 to S. 3240 (Agriculture Reform, Food, and Jobs Act of 2012)",65,33,2,0,100
428779,216061,2012-06-19,Senate,"On the Amendment S.Amdt. 2192 to S. 3240 (Agriculture Reform, Food, and Jobs Act of 2012)",38,61,1,0,100
428779,216062,2012-06-19,Senate,"On the Amendment S.Amdt. 2190 to S. 3240 (Agriculture Reform, Food, and Jobs Act of 2012)",66,33,1,0,100
428779,216063,2012-06-19,Senate,"On the Amendment S.Amdt. 2167 to S. 3240 (Agriculture Reform, Food, and Jobs Act of 2012)",75,24,1,0,100
428779,216064,2012-06-19,Senate,"On the Amendment S.Amdt. 2445 to S. 3240 (Agriculture Reform, Food, and Jobs Act of 2012)",55,44,1,0,100
428779,216065,2012-06-19,Senate,"On the Amendment S.Amdt. 2174 to S. 3240 (Agriculture Reform, Food, and Jobs Act of 2012)",43,56,1,0,100
428779,216066,2012-06-19,Senate,"On the Amendment S.Amdt. 2370 to S. 3240 (Agriculture Reform, Food, and Jobs Act of 2012)",58,41,1,0,100
428779,216067,2012-06-19,Senate,"On the Amendment S.Amdt. 2172 to S. 3240 (Agriculture Reform, Food, and Jobs Act of 2012)",41,58,1,0,100
428779,216068,2012-06-19,Senate,"On the Amendment S.Amdt. 2238 to S. 3240 (Agriculture Reform, Food, and Jobs Act of 2012)",73,26,1,0,100
428779,216069,2012-06-19,Senate,"On the Amendment S.Amdt. 2181 to S. 3240 (Agriculture Reform, Food, and Jobs Act of 2012)",15,84,1,0,100
428779,216070,2012-06-19,Senate,"On the Amendment S.Amdt. 2191 to S. 3240 (Agriculture Reform, Food, and Jobs Act of 2012)",33,66,1,0,100
428779,216071,2012-06-19,Senate,"On the Amendment S.Amdt. 2309 to S. 3240 (Agriculture Reform, Food, and Jobs Act of 2012)",76,23,1,0,100
428779,216072,2012-06-19,Senate,"On the Amendment S.Amdt. 2217 to S. 3240 (Agriculture Reform, Food, and Jobs Act of 2012)",42,57,1,0,100
428779,216073,2012-06-19,Senate,"On the Amendment S.Amdt. 2156 to S. 3240 (Agriculture Reform, Food, and Jobs Act of 2012)",33,66,1,0,100
428779,216074,2012-06-19,Senate,"On the Amendment S.Amdt. 2263 to S. 3240 (Agriculture Reform, Food, and Jobs Act of 2012)",45,54,1,0,100
428779,216075,2012-06-19,Senate,"On the Amendment S.Amdt. 2268 to S. 3240 (Agriculture Reform, Food, and Jobs Act of 2012)",14,84,2,0,100
428779,216076,2012-06-19,Senate,"On the Amendment S.Amdt. 2276 to S. 3240 (Agriculture Reform, Food, and Jobs Act of 2012)",20,79,1,0,100
428779,216077,2012-06-20,Senate,"On the Amendment S.Amdt. 2382 to S. 3240 (Agriculture Reform, Food, and Jobs Act of 2012)",63,36,1,0,100
428779,216078,2012-06-20,Senate,"On the Amendment S.Amdt. 2273 to S. 3240 (Agriculture Reform, Food, and Jobs Act of 2012)",44,55,1,0,100
428779,216079,2012-06-20,Senate,"On the Amendment S.Amdt. 2289 to S. 3240 (Agriculture Reform, Food, and Jobs Act of 2012)",30,69,1,0,100
428779,216080,2012-06-20,Senate,"On the Amendment S.Amdt. 2293 to S. 3240 (Agriculture Reform, Food, and Jobs Act of 2012)",62,37,1,0,100
428779,216081,2012-06-20,Senate,"On the Amendment S.Amdt. 2454 to S. 3240 (Agriculture Reform, Food, and Jobs Act of 2012)",59,40,1,0,100
428779,216082,2012-06-20,Senate,"On the Amendment S.Amdt. 2354 to S. 3240 (Agriculture Reform, Food, and Jobs Act of 2012)",43,56,1,0,100
428779,216083,2012-06-20,Senate,"On the Amendment S.Amdt. 2295 to S. 3240 (Agriculture Reform, Food, and Jobs Act of 2012)",77,22,1,0,100
428779,216084,2012-06-20,Senate,"On the Amendment S.Amdt. 2313 to S. 3240 (Agriculture Reform, Food, and Jobs Act of 2012)",21,77,2,0,100
428779,216085,2012-06-20,Senate,"On the Amendment S.Amdt. 2314 to S. 3240 (Agriculture Reform, Food, and Jobs Act of 2012)",15,84,1,0,100
428779,216086,2012-06-20,Senate,"On the Amendment S.Amdt. 2360 to S. 3240 (Agriculture Reform, Food, and Jobs Act of 2012)",35,63,1,0,99
428779,216087,2012-06-20,Senate,"On the Amendment S.Amdt. 2226 to S. 3240 (Agriculture Reform, Food, and Jobs Act of 2012)",36,63,1,0,100
428779,216088,2012-06-20,Senate,"On the Amendment S.Amdt. 2433 to S. 3240 (Agriculture Reform, Food, and Jobs Act of 2012)",46,53,1,0,100
428779,216089,2012-06-20,Senate,"On the Motion to Recommit S. 3240",29,70,1,0,100
428779,216090,2012-06-20,Senate,"On the Motion (Johnson (WI) Motion to Recommit with Instructions)",40,59,1,0,100
428779,216091,2012-06-20,Senate,"On the Amendment S.Amdt. 2363 to S. 3240 (Agriculture Reform, Food, and Jobs Act of 2012)",88,11,1,0,100
428779,216092,2012-06-20,Senate,"On the Amendment S.Amdt. 2438 to S. 3240 (Agriculture Reform, Food, and Jobs Act of 2012)",52,47,1,0,100
428779,216093,2012-06-20,Senate,"On the Amendment S.Amdt. 2437 to S. 3240 (Agriculture Reform, Food, and Jobs Act of 2012)",44,55,1,0,100
428779,216094,2012-06-20,Senate,"On the Amendment S.Amdt. 2439 to S. 3240 (Agriculture Reform, Food, and Jobs Act of 2012)",66,33,1,0,100
428779,216095,2012-06-21,Senate,"On the Amendment S.Amdt. 2456 to S. 3240 (Agriculture Reform, Food, and Jobs Act of 2012)",47,48,5,0,100
428779,216096,2012-06-21,Senate,"On the Amendment S.Amdt. 2372 to S. 3240 (Agriculture Reform, Food, and Jobs Act of 2012)",56,43,1,0,100
428779,216097,2012-06-21,Senate,"On the Amendment S.Amdt. 2247 to S. 3240 (Agriculture Reform, Food, and Jobs Act of 2012)",58,41,1,0,100
428779,216098,2012-06-21,Senate,"On the Amendment S.Amdt. 2310 to S. 3240 (Agriculture Reform, Food, and Jobs Act of 2012)",26,73,1,0,100
428779,216099,2012-06-21,Senate,"On the Amendment S.Amdt. 2214 to S. 3240 (Agriculture Reform, Food, and Jobs Act of 2012)",95,4,1,0,100
428779,216100,2012-06-21,Senate,"On the Amendment S.Amdt. 2166 to S. 3240 (Agriculture Reform, Food, and Jobs Act of 2012)",45,54,1,0,100
428779,216101,2012-06-21,Senate,"On Passage of the Bill S. 3240",64,35,1,0,100
428800,216275,2012-07-18,House,"On Agreeing to the Amendment",166,250,15,0,431
428800,216276,2012-07-18,House,"On Agreeing to the Amendment",202,216,13,0,431
428800,216277,2012-07-18,House,"On Agreeing to the Amendment",60,359,12,0,431
428800,216278,2012-07-18,House,"On Agreeing to the Amendment",145,273,13,0,431
428800,216279,2012-07-18,House,"On Agreeing to the Amendment",137,282,12,0,431
428800,216280,2012-07-18,House,"On Agreeing to the Amendment",150,268,13,0,431
428800,216281,2012-07-18,House,"On Agreeing to the Amendment",186,233,12,0,431
428800,216282,2012-07-18,House,"On Agreeing to the Amendment",228,191,12,0,431
428800,216283,2012-07-18,House,"On Agreeing to the Amendment",149,270,12,0,431
428800,216284,2012-07-18,House,"On Agreeing to the Amendment",114,302,15,0,431
428800,216285,2012-07-18,House,"On Agreeing to the Amendment",136,283,12,0,431
428800,216286,2012-07-18,House,"On Agreeing to the Amendment",106,311,14,0,431
428800,216287,2012-07-18,House,"On Agreeing to the Amendment",91,328,12,0,431
428800,216288,2012-07-18,House,"On Agreeing to the Amendment",107,312,12,0,431
428800,216289,2012-07-18,House,"On Agreeing to the Amendment",182,235,14,0,431
428800,216290,2012-07-19,House,"On Agreeing to the Amendment",247,166,18,0,431
428800,216291,2012-07-19,House,"On Agreeing to the Amendment",87,326,18,0,431
428800,216292,2012-07-19,House,"On Agreeing to the Amendment",171,243,17,0,431
428800,216293,2012-07-19,House,"On Agreeing to the Amendment",407,5,19,0,431
428800,216294,2012-07-19,House,"On Agreeing to the Amendment",235,178,18,0,431
428800,216295,2012-07-19,House,"On Agreeing to the Amendment",123,292,16,0,431
428800,216296,2012-07-19,House,"On Agreeing to the Amendment",232,183,16,0,431
428800,216297,2012-07-19,House,"On Agreeing to the Amendment",137,278,16,0,431
428800,216298,2012-07-19,House,"On Agreeing to the Amendment",247,167,17,0,431
428800,216299,2012-07-19,House,"On Agreeing to the Amendment",238,178,15,0,431
428800,216300,2012-07-19,House,"On Agreeing to the Amendment",399,17,15,0,431
428800,216301,2012-07-19,House,"On Passage",326,90,15,0,431
428800,220157,2012-07-18,House,"On Agreeing to the Amendment",166,250,15,0,431
428800,220158,2012-07-18,House,"On Agreeing to the Amendment",202,216,13,0,431
428800,220159,2012-07-18,House,"On Agreeing to the Amendment",60,359,12,0,431
428800,220160,2012-07-18,House,"On Agreeing to the Amendment",145,273,13,0,431
428800,220161,2012-07-18,House,"On Agreeing to the Amendment",137,282,12,0,431
428800,220162,2012-07-18,House,"On Agreeing to the Amendment",150,268,13,0,431
428800,220163,2012-07-18,House,"On Agreeing to the Amendment",186,233,12,0,431
428800,220164,2012-07-18,House,"On Agreeing to the Amendment",228,191,12,0,431
428800,220165,2012-07-18,House,"On Agreeing to the Amendment",149,270,12,0,431
428800,220166,2012-07-18,House,"On Agreeing to the Amendment",114,302,15,0,431
428800,220167,2012-07-18,House,"On Agreeing to the Amendment",136,283,12,0,431
428800,220168,2012-07-18,House,"On Agreeing to the Amendment",106,311,14,0,431
428800,220169,2012-07-18,House,"On Agreeing to the Amendment",91,328,12,0,431
428800,220170,2012-07-18,House,"On Agreeing to the Amendment",107,312,12,0,431
428800,220171,2012-07-18,House,"On Agreeing to the Amendment",182,235,14,0,431
428800,220172,2012-07-19,House,"On Agreeing to the Amendment",247,166,18,0,431
428800,220173,2012-07-19,House,"On Agreeing to the Amendment",87,326,18,0,431
428800,220174,2012-07-19,House,"On Agreeing to the Amendment",171,243,17,0,431
428800,220175,2012-07-19,House,"On Agreeing to the Amendment",407,5,19,0,431
428800,220176,2012-07-19,House,"On Agreeing to the Amendment",235,178,18,0,431
428800,220177,2012-07-19,House,"On Agreeing to the Amendment",123,292,16,0,431
428800,220178,2012-07-19,House,"On Agreeing to the Amendment",232,183,16,0,431
428800,220179,2012-07-19,House,"On Agreeing to the Amendment",137,278,16,0,431
428800,220180,2012-07-19,House,"On Agreeing to the Amendment",247,167,17,0,431
428800,220181,2012-07-19,House,"On Agreeing to the Amendment",238,178,15,0,431
428800,220182,2012-07-19,House,"On Agreeing to the Amendment",399,17,15,0,431
428800,220183,2012-07-19,House,"On Passage",326,90,15,0,431
428819,216210,2012-12-17,House,"On Motion to Suspend the Rules and Pass, as Amended",286,10,135,0,431
428819,219925,2012-12-17,House,"On Motion to Suspend the Rules and Pass, as Amended",286,10,135,0,431
429452,216542,2012-08-02,House,"On Motion to Suspend the Rules and Agree",414,0,16,0,430
429452,220933,2012-08-02,House,"On Motion to Suspend the Rules and Agree",414,0,16,0,430
429467,216754,2012-05-31,House,"On Ordering the Previous Question",233,180,18,0,431
429467,216755,2012-05-31,House,"On Agreeing to the Resolution",246,166,19,0,431
429467,221377,2012-05-31,House,"On Ordering the Previous Question",233,180,18,0,431
429467,221378,2012-05-31,House,"On Agreeing to the Resolution",246,166,19,0,431
429484,216322,2012-12-19,House,"On Motion to Suspend the Rules and Agree, as Amended",398,5,28,0,431
429484,220321,2012-12-19,House,"On Motion to Suspend the Rules and Agree, as Amended",398,5,28,0,431
429545,216998,2012-09-13,House,"On Motion to Suspend the Rules and Pass",412,3,14,0,429
429545,219190,2012-09-13,House,"On Motion to Suspend the Rules and Pass",412,3,14,0,429
429591,216185,2012-07-18,House,"On Motion to Suspend the Rules and Pass, as Amended",414,2,15,0,431
429591,219805,2012-07-18,House,"On Motion to Suspend the Rules and Pass, as Amended",414,2,15,0,431
429676,216498,2012-09-12,House,"On Motion to Suspend the Rules and Pass, as Amended",339,77,13,0,429
429676,220819,2012-09-12,House,"On Motion to Suspend the Rules and Pass, as Amended",339,77,13,0,429
429679,216913,2012-06-08,House,"On Agreeing to the Amendment",213,193,25,0,431
429679,216914,2012-06-08,House,"On Agreeing to the Amendment",214,189,28,0,431
429679,216915,2012-06-08,House,"On Agreeing to the Amendment",204,203,24,0,431
429679,216916,2012-06-08,House,"On Agreeing to the Amendment",178,229,24,0,431
429679,216917,2012-06-08,House,"On Agreeing to the Amendment",148,261,22,0,431
429679,216918,2012-06-08,House,"On Motion to Recommit with Instructions",101,309,21,0,431
429679,216919,2012-06-08,House,"On Passage",307,102,22,0,431
429679,218958,2012-06-08,House,"On Agreeing to the Amendment",213,193,25,0,431
429679,218959,2012-06-08,House,"On Agreeing to the Amendment",214,189,28,0,431
429679,218960,2012-06-08,House,"On Agreeing to the Amendment",204,203,24,0,431
429679,218961,2012-06-08,House,"On Agreeing to the Amendment",178,229,24,0,431
429679,218962,2012-06-08,House,"On Agreeing to the Amendment",148,261,22,0,431
429679,218963,2012-06-08,House,"On Motion to Recommit with Instructions",101,309,21,0,431
429679,218964,2012-06-08,House,"On Passage",307,102,22,0,431
429912,216321,2012-09-22,Senate,"On the Joint Resolution S.J.Res. 41",90,1,9,0,100
430033,216036,2012-11-30,Senate,"On the Amendment S.Amdt. 3025 to S. 3254 (National Defense Authorization Act for Fiscal Year 2013)",41,53,6,0,100
430033,216037,2012-11-30,Senate,"On the Motion (Motion to Waive Sec. 302(f) of the CBA)",58,34,8,0,100
430033,216038,2012-12-04,Senate,"On Passage of the Bill S. 3254",98,0,2,0,100
430033,217036,2012-11-28,Senate,"On the Amendment S.Amdt. 2985 to S. 3254 (National Defense Authorization Act for Fiscal Year 2013)",62,37,1,0,100
430033,217037,2012-11-28,Senate,"On the Amendment S.Amdt. 2955 to S. 3254 (National Defense Authorization Act for Fiscal Year 2013)",85,11,4,0,100
430033,217038,2012-11-29,Senate,"On the Amendment S.Amdt. 3158 to S. 3254 (National Defense Authorization Act for Fiscal Year 2013)",95,0,5,0,100
430033,217039,2012-11-29,Senate,"On the Amendment S.Amdt. 3095 to S. 3254 (National Defense Authorization Act for Fiscal Year 2013)",54,41,5,0,100
430033,217040,2012-11-29,Senate,"On the Amendment S.Amdt. 3096 to S. 3254 (National Defense Authorization Act for Fiscal Year 2013)",62,33,5,0,100
430033,217041,2012-11-29,Senate,"On the Amendment S.Amdt. 3058 to S. 3254 (National Defense Authorization Act for Fiscal Year 2013)",66,29,5,0,100
430033,217042,2012-11-29,Senate,"On the Amendment S.Amdt. 3245 to S. 3254 (National Defense Authorization Act for Fiscal Year 2013)",54,41,5,0,100
430033,217043,2012-11-29,Senate,"On the Amendment S.Amdt. 3018 to S. 3254 (National Defense Authorization Act for Fiscal Year 2013)",67,29,4,0,100
430033,217044,2012-11-30,Senate,"On the Amendment S.Amdt. 3232 to S. 3254 (National Defense Authorization Act for Fiscal Year 2013)",94,0,6,0,100
430033,217045,2012-12-03,Senate,"On the Cloture Motion S. 3254",93,0,7,0,100
430033,217046,2012-12-04,Senate,"On the Amendment S.Amdt. 3262 to S. 3254 (National Defense Authorization Act for Fiscal Year 2013)",92,6,2,0,100
430035,216323,2012-06-07,House,"On Ordering the Previous Question",240,179,12,0,431
430035,216324,2012-06-07,House,"On Agreeing to the Resolution",241,173,17,0,431
430035,220324,2012-06-07,House,"On Ordering the Previous Question",240,179,12,0,431
430035,220325,2012-06-07,House,"On Agreeing to the Resolution",241,173,17,0,431
430048,216936,2012-07-09,House,"On Motion to Suspend the Rules and Pass",372,0,59,0,431
430048,218992,2012-07-09,House,"On Motion to Suspend the Rules and Pass",372,0,59,0,431
430357,216501,2012-09-19,House,"On Motion to Suspend the Rules and Pass, as Amended",310,95,24,0,429
430357,220874,2012-09-19,House,"On Motion to Suspend the Rules and Pass, as Amended",310,95,24,0,429
430832,216472,2012-09-12,House,"On Passage",301,118,10,0,429
430832,216473,2012-12-27,Senate,"On the Amendment S.Amdt. 3437 to H.R. 5949 (FISA Amendments Act Reauthorization Act of 2012)",38,52,10,0,100
430832,216474,2012-12-27,Senate,"On the Amendment S.Amdt. 3435 to H.R. 5949 (FISA Amendments Act Reauthorization Act of 2012)",37,54,9,0,100
430832,216475,2012-12-27,Senate,"On the Amendment S.Amdt. 3436 to H.R. 5949 (FISA Amendments Act Reauthorization Act of 2012)",12,79,9,0,100
430832,216476,2012-12-28,Senate,"On the Amendment S.Amdt. 3439 to H.R. 5949 (FISA Amendments Act Reauthorization Act of 2012)",43,52,5,0,100
430832,216477,2012-12-28,Senate,"On Passage of the Bill H.R. 5949",73,23,4,0,100
430832,220673,2012-09-12,House,"On Passage",301,118,10,0,429
430985,216496,2012-06-19,House,"On Ordering the Previous Question",238,178,15,0,431
430985,216497,2012-06-19,House,"On Agreeing to the Resolution",240,175,17,0,432
430985,220773,2012-06-19,House,"On Ordering the Previous Question",238,178,15,0,431
430985,220774,2012-06-19,House,"On Agreeing to the Resolution",240,175,17,0,432
431040,216819,2012-06-20,House,"On Ordering the Previous Question",242,183,7,0,432
431040,216820,2012-06-20,House,"On Agreeing to the Resolution",245,178,9,0,432
431040,218577,2012-06-20,House,"On Ordering the Previous Question",242,183,7,0,432
431040,218578,2012-06-20,House,"On Agreeing to the Resolution",245,178,9,0,432
431160,216868,2012-06-26,House,"On Agreeing to the Amendment",175,222,35,0,432
431160,216869,2012-06-26,House,"On Agreeing to the Amendment",164,238,30,0,432
431160,216870,2012-06-26,House,"On Agreeing to the Amendment",160,243,29,0,432
431160,216871,2012-06-26,House,"On Agreeing to the Amendment",184,218,30,0,432
431160,216872,2012-06-26,House,"On Agreeing to the Amendment",179,224,29,0,432
431160,216873,2012-06-26,House,"On Agreeing to the Amendment",173,230,29,0,432
431160,216874,2012-06-26,House,"On Agreeing to the Amendment",188,215,29,0,432
431160,216875,2012-06-26,House,"On Agreeing to the Amendment",138,265,29,0,432
431160,216876,2012-06-27,House,"On Agreeing to the Amendment",168,256,8,0,432
431160,216877,2012-06-27,House,"On Agreeing to the Amendment",178,240,14,0,432
431160,216878,2012-06-27,House,"On Agreeing to the Amendment",174,248,10,0,432
431160,216879,2012-06-27,House,"On Agreeing to the Amendment",193,229,10,0,432
431160,216880,2012-06-27,House,"On Agreeing to the Amendment",178,247,7,0,432
431160,216881,2012-06-27,House,"On Agreeing to the Amendment",169,250,13,0,432
431160,216882,2012-06-27,House,"On Agreeing to the Amendment",160,264,8,0,432
431160,216883,2012-06-27,House,"On Agreeing to the Amendment",172,249,11,0,432
431160,216884,2012-06-27,House,"On Agreeing to the Amendment",172,250,10,0,432
431160,216885,2012-06-27,House,"On Agreeing to the Amendment",157,267,8,0,432
431160,216886,2012-06-27,House,"On Agreeing to the Amendment",80,342,10,0,432
431160,216887,2012-06-27,House,"On Agreeing to the Amendment",123,300,9,0,432
431160,216888,2012-06-27,House,"On Agreeing to the Amendment",178,242,12,0,432
431160,216889,2012-06-29,House,"On Agreeing to the Amendment",166,254,12,0,432
431160,216890,2012-06-29,House,"On Agreeing to the Amendment",235,186,11,0,432
431160,216891,2012-06-29,House,"On Agreeing to the Amendment",234,191,7,0,432
431160,216892,2012-06-29,House,"On Agreeing to the Amendment",239,185,8,0,432
431160,216893,2012-06-29,House,"On Motion to Recommit with Instructions",188,233,11,0,432
431160,216894,2012-06-29,House,"On Passage",261,163,8,0,432
431160,218849,2012-06-26,House,"On Agreeing to the Amendment",175,222,35,0,432
431160,218850,2012-06-26,House,"On Agreeing to the Amendment",164,238,30,0,432
431160,218851,2012-06-26,House,"On Agreeing to the Amendment",160,243,29,0,432
431160,218852,2012-06-26,House,"On Agreeing to the Amendment",184,218,30,0,432
431160,218853,2012-06-26,House,"On Agreeing to the Amendment",179,224,29,0,432
431160,218854,2012-06-26,House,"On Agreeing to the Amendment",173,230,29,0,432
431160,218855,2012-06-26,House,"On Agreeing to the Amendment",188,215,29,0,432
431160,218856,2012-06-26,House,"On Agreeing to the Amendment",138,265,29,0,432
431160,218857,2012-06-27,House,"On Agreeing to the Amendment",168,256,8,0,432
431160,218858,2012-06-27,House,"On Agreeing to the Amendment",178,240,14,0,432
431160,218859,2012-06-27,House,"On Agreeing to the Amendment",174,248,10,0,432
431160,218860,2012-06-27,House,"On Agreeing to the Amendment",193,229,10,0,432
431160,218861,2012-06-27,House,"On Agreeing to the Amendment",178,247,7,0,432
431160,218862,2012-06-27,House,"On Agreeing to the Amendment",169,250,13,0,432
431160,218863,2012-06-27,House,"On Agreeing to the Amendment",160,264,8,0,432
431160,218864,2012-06-27,House,"On Agreeing to the Amendment",172,249,11,0,432
431160,218865,2012-06-27,House,"On Agreeing to the Amendment",172,250,10,0,432
431160,218866,2012-06-27,House,"On Agreeing to the Amendment",157,267,8,0,432
431160,218867,2012-06-27,House,"On Agreeing to the Amendment",80,342,10,0,432
431160,218868,2012-06-27,House,"On Agreeing to the Amendment",123,300,9,0,432
431160,218869,2012-06-27,House,"On Agreeing to the Amendment",178,242,12,0,432
431160,218870,2012-06-29,House,"On Agreeing to the Amendment",166,254,12,0,432
431160,218871,2012-06-29,House,"On Agreeing to the Amendment",235,186,11,0,432
431160,218872,2012-06-29,House,"On Agreeing to the Amendment",234,191,7,0,432
431160,218873,2012-06-29,House,"On Agreeing to the Amendment",239,185,8,0,432
431160,218874,2012-06-29,House,"On Motion to Recommit with Instructions",188,233,11,0,432
431160,218875,2012-06-29,House,"On Passage",261,163,8,0,432
431230,216783,2012-06-26,House,"On Ordering the Previous Question",226,168,38,0,432
431230,216784,2012-06-26,House,"On Agreeing to the Resolution",229,166,37,0,432
431230,221511,2012-06-26,House,"On Ordering the Previous Question",226,168,38,0,432
431230,221512,2012-06-26,House,"On Agreeing to the Resolution",229,166,37,0,432
431425,216839,2012-09-20,House,"On Motion to Suspend the Rules and Pass, as Amended",237,180,12,0,429
431425,218750,2012-09-20,House,"On Motion to Suspend the Rules and Pass, as Amended",237,180,12,0,429
431433,216728,2012-07-17,House,"On Motion to Suspend the Rules and Pass, as Amended",333,61,37,0,431
431433,221258,2012-07-17,House,"On Motion to Suspend the Rules and Pass, as Amended",333,61,37,0,431
431441,216365,2012-06-28,House,"On Agreeing to the Resolution",258,95,79,0,432
431441,220422,2012-06-28,House,"On Agreeing to the Resolution",258,95,79,0,432
431491,216719,2012-11-27,House,"On Motion to Suspend the Rules and Pass, as Amended",397,1,34,0,432
431491,221248,2012-11-27,House,"On Motion to Suspend the Rules and Pass, as Amended",397,1,34,0,432
431511,216940,2012-12-19,House,"On Motion to Suspend the Rules and Pass, as Amended",402,2,27,0,431
431511,219008,2012-12-19,House,"On Motion to Suspend the Rules and Pass, as Amended",402,2,27,0,431
431516,216366,2012-06-28,House,"On Agreeing to the Resolution",254,173,5,0,432
431516,220421,2012-06-28,House,"On Agreeing to the Resolution",254,173,5,0,432
431556,216850,2012-12-05,House,"On Motion to Suspend the Rules and Agree",397,0,34,0,431
431556,218810,2012-12-05,House,"On Motion to Suspend the Rules and Agree",397,0,34,0,431
431563,216901,2012-08-02,Senate,"On the Amendment S.Amdt. 2771 to S. 3326 (No short title on file)",40,58,2,0,100
431601,216319,2012-06-28,House,"On Motion to Refer the Resolution to Oversight and Government Reform",172,251,9,0,432
431601,216320,2012-06-28,House,"On Agreeing to the Resolution",255,67,110,0,432
431601,220308,2012-06-28,House,"On Motion to Refer the Resolution to Oversight and Government Reform",172,251,9,0,432
431601,220309,2012-06-28,House,"On Agreeing to the Resolution",255,67,110,0,432
431613,216758,2012-06-29,House,"On Agreeing to the Resolution",244,176,12,0,432
431613,221390,2012-06-29,House,"On Agreeing to the Resolution",244,176,12,0,432
431707,216645,2012-06-29,House,"On Motion to Table",259,161,12,0,432
431707,221195,2012-06-29,House,"On Motion to Table",259,161,12,0,432
431785,216932,2012-07-10,House,"On Ordering the Previous Question",238,184,9,0,431
431785,216933,2012-07-10,House,"On Agreeing to the Resolution",240,182,9,0,431
431785,218987,2012-07-10,House,"On Ordering the Previous Question",238,184,9,0,431
431785,218988,2012-07-10,House,"On Agreeing to the Resolution",240,182,9,0,431
431788,216629,2012-07-25,House,"On Agreeing to the Amendment",163,253,15,0,431
431788,216630,2012-07-25,House,"On Agreeing to the Amendment",158,262,11,0,431
431788,216631,2012-07-25,House,"On Agreeing to the Amendment",189,232,10,0,431
431788,216632,2012-07-25,House,"On Agreeing to the Amendment",177,247,7,0,431
431788,216633,2012-07-25,House,"On Agreeing to the Amendment",158,266,7,0,431
431788,216634,2012-07-25,House,"On Agreeing to the Amendment",150,275,6,0,431
431788,216635,2012-07-25,House,"On Motion to Recommit with Instructions",179,240,12,0,431
431788,216636,2012-07-25,House,"On Passage",253,170,8,0,431
431788,221144,2012-07-25,House,"On Agreeing to the Amendment",163,253,15,0,431
431788,221145,2012-07-25,House,"On Agreeing to the Amendment",158,262,11,0,431
431788,221146,2012-07-25,House,"On Agreeing to the Amendment",189,232,10,0,431
431788,221147,2012-07-25,House,"On Agreeing to the Amendment",177,247,7,0,431
431788,221148,2012-07-25,House,"On Agreeing to the Amendment",158,266,7,0,431
431788,221149,2012-07-25,House,"On Agreeing to the Amendment",150,275,6,0,431
431788,221150,2012-07-25,House,"On Motion to Recommit with Instructions",179,240,12,0,431
431788,221151,2012-07-25,House,"On Passage",253,170,8,0,431
431789,216969,2012-07-11,House,"On Motion to Recommit with Instructions",180,248,3,0,431
431789,216970,2012-07-11,House,"On Passage",244,185,2,0,431
431789,219097,2012-07-11,House,"On Motion to Recommit with Instructions",180,248,3,0,431
431789,219098,2012-07-11,House,"On Passage",244,185,2,0,431
431807,216270,2012-07-11,House,"On Agreeing to the Resolution",245,180,6,0,431
431807,220128,2012-07-11,House,"On Agreeing to the Resolution",245,180,6,0,431
431832,216054,2012-07-19,Senate,"On Cloture on the Motion to Proceed S. 3364",56,42,2,0,100
431851,216833,2012-07-16,Senate,"On Cloture on the Motion to Proceed S. 3369",51,44,5,0,100
431851,216834,2012-07-17,Senate,"On Cloture on the Motion to Proceed S. 3369",53,45,2,0,100
431908,216865,2012-09-10,House,"On Motion to Suspend the Rules and Pass",377,0,52,0,429
431908,218835,2012-09-10,House,"On Motion to Suspend the Rules and Pass",377,0,52,0,429
432097,216117,2012-07-25,Senate,"On the Amendment S.Amdt. 2573 to S. 3412 (Middle Class Tax Cut Act)",45,54,1,0,100
432097,216118,2012-07-25,Senate,"On Passage of the Bill S. 3412",51,48,1,0,100
432123,216478,2012-11-16,House,"On Passage",365,43,25,0,433
432123,216479,2012-12-06,Senate,"On Passage of the Bill H.R. 6156",92,4,4,0,100
432123,220674,2012-11-16,House,"On Passage",365,43,25,0,433
432160,216899,2012-07-24,House,"On Ordering the Previous Question",238,177,16,0,431
432160,216900,2012-07-24,House,"On Agreeing to the Resolution",244,170,17,0,431
432160,218913,2012-07-24,House,"On Ordering the Previous Question",238,177,16,0,431
432160,218914,2012-07-24,House,"On Agreeing to the Resolution",244,170,17,0,431
432173,216806,2012-07-26,Senate,"On Cloture on the Motion to Proceed S. 3414",84,11,5,0,100
432173,216807,2012-07-31,Senate,"On the Cloture Motion S. 3414",52,46,2,0,100
432173,216808,2012-11-14,Senate,"On the Cloture Motion S. 3414",51,47,2,0,100
432181,216228,2012-08-01,House,"On Agreeing to the Amendment",170,257,3,0,430
432181,216229,2012-08-01,House,"On Motion to Recommit with Instructions",181,246,3,0,430
432181,216230,2012-08-01,House,"On Passage",256,171,3,0,430
432181,220016,2012-08-01,House,"On Agreeing to the Amendment",170,257,3,0,430
432181,220017,2012-08-01,House,"On Motion to Recommit with Instructions",181,246,3,0,430
432181,220018,2012-08-01,House,"On Passage",256,171,3,0,430
432181,220019,2013-01-01,House,"On Motion to Concur in the Senate Amendments",257,167,8,0,432
432182,216109,2012-07-25,House,"On Motion to Suspend the Rules and Pass",164,261,6,0,431
432182,219576,2012-07-25,House,"On Motion to Suspend the Rules and Pass",164,261,6,0,431
432183,216488,2012-08-02,House,"On Agreeing to the Amendment",176,246,8,0,430
432183,216489,2012-08-02,House,"On Motion to Recommit with Instructions",188,235,7,0,430
432183,216490,2012-08-02,House,"On Passage",232,189,9,0,430
432183,220728,2012-08-02,House,"On Agreeing to the Amendment",176,246,8,0,430
432183,220729,2012-08-02,House,"On Motion to Recommit with Instructions",188,235,7,0,430
432183,220730,2012-08-02,House,"On Passage",232,189,9,0,430
432224,216487,2012-07-26,House,"On Ordering the Previous Question",235,183,13,0,431
432224,220722,2012-07-26,House,"On Ordering the Previous Question",235,183,13,0,431
432318,216816,2012-09-10,House,"On Motion to Suspend the Rules and Pass",364,11,54,0,429
432318,218567,2012-09-10,House,"On Motion to Suspend the Rules and Pass",364,11,54,0,429
432321,216199,2012-12-12,House,"On Motion to Suspend the Rules and Pass",229,182,20,0,431
432321,219840,2012-12-12,House,"On Motion to Suspend the Rules and Pass",229,182,20,0,431
432326,216050,2012-09-14,House,"On Agreeing to the Amendment",169,238,22,0,429
432326,216051,2012-09-14,House,"On Agreeing to the Amendment",170,231,28,0,429
432326,216052,2012-09-14,House,"On Motion to Recommit with Instructions",175,234,20,0,429
432326,216053,2012-09-14,House,"On Passage",245,161,23,0,429
432326,219455,2012-09-14,House,"On Agreeing to the Amendment",169,238,22,0,429
432326,219456,2012-09-14,House,"On Agreeing to the Amendment",170,231,28,0,429
432326,219457,2012-09-14,House,"On Motion to Recommit with Instructions",175,234,20,0,429
432326,219458,2012-09-14,House,"On Passage",245,161,23,0,429
432454,216502,2012-08-02,House,"On Motion to Recommit with Instructions",189,232,9,0,430
432454,216503,2012-08-02,House,"On Passage",223,197,10,0,430
432454,220871,2012-08-02,House,"On Motion to Recommit with Instructions",189,232,9,0,430
432454,220872,2012-08-02,House,"On Passage",223,197,10,0,430
432457,216480,2012-08-01,House,"On Ordering the Previous Question",240,183,7,0,430
432457,216481,2012-08-01,House,"On Agreeing to the Amendment",238,186,6,0,430
432457,216482,2012-08-01,House,"On Agreeing to the Resolution, as Amended",240,184,6,0,430
432457,220681,2012-08-01,House,"On Ordering the Previous Question",240,183,7,0,430
432457,220682,2012-08-01,House,"On Agreeing to the Amendment",238,186,6,0,430
432457,220683,2012-08-01,House,"On Agreeing to the Resolution, as Amended",240,184,6,0,430
432458,216423,2012-12-31,House,"On Motion to Suspend the Rules and Pass",373,29,29,0,431
432458,220510,2012-12-31,House,"On Motion to Suspend the Rules and Pass",373,29,29,0,431
432490,216049,2012-09-19,Senate,"On the Motion (Motion to Waive All Applicable Budgetary Discipline Re: Amdt. No. 2789)",58,40,2,0,100
432490,217060,2012-09-11,Senate,"On Cloture on the Motion to Proceed S. 3457",95,1,4,0,100
432490,217061,2012-09-12,Senate,"On the Motion to Proceed S. 3457",84,8,8,0,100
432494,216902,2012-08-02,House,"On Ordering the Previous Question",236,182,12,0,430
432494,216903,2012-08-02,House,"On Agreeing to the Resolution",235,181,14,0,430
432494,218917,2012-08-02,House,"On Ordering the Previous Question",236,182,12,0,430
432494,218918,2012-08-02,House,"On Agreeing to the Resolution",235,181,14,0,430
432519,216841,2012-08-02,House,"On Agreeing to the Resolution",150,265,15,0,430
432519,218777,2012-08-02,House,"On Agreeing to the Resolution",150,265,15,0,430
432522,216432,2012-08-01,House,"On Motion to Suspend the Rules and Agree",421,6,3,0,430
432522,220610,2012-08-01,House,"On Motion to Suspend the Rules and Agree",421,6,3,0,430
433167,216842,2012-09-11,House,"On Ordering the Previous Question",232,177,20,0,429
433167,216843,2012-09-11,House,"On Agreeing to the Resolution",233,179,17,0,429
433167,218789,2012-09-11,House,"On Ordering the Previous Question",232,177,20,0,429
433167,218790,2012-09-11,House,"On Agreeing to the Resolution",233,179,17,0,429
433171,216029,2012-09-13,House,"On Motion to Recommit with Instructions",189,232,8,0,429
433171,216030,2012-09-13,House,"On Passage",329,91,9,0,429
433171,216031,2012-09-22,Senate,"On the Joint Resolution H.J.Res. 117",62,30,8,0,100
433171,217023,2012-09-19,Senate,"On Cloture on the Motion to Proceed H.J.Res. 117",76,22,2,0,100
433171,217024,2012-09-20,Senate,"On the Motion to Proceed H.J.Res. 117",67,31,2,0,100
433171,217025,2012-09-20,Senate,"On the Cloture Motion H.J.Res. 117",62,30,8,0,100
433171,219347,2012-09-13,House,"On Motion to Recommit with Instructions",189,232,8,0,429
433171,219348,2012-09-13,House,"On Passage",329,91,9,0,429
433179,216219,2012-09-13,House,"On Motion to Recommit with Instructions",170,247,12,0,429
433179,216220,2012-09-13,House,"On Passage",223,196,10,0,429
433179,219952,2012-09-13,House,"On Motion to Recommit with Instructions",170,247,12,0,429
433179,219953,2012-09-13,House,"On Passage",223,196,10,0,429
433184,216145,2012-12-31,House,"On Motion to Suspend the Rules and Concur in the Senate Amendment",401,5,25,0,431
433184,219749,2012-12-31,House,"On Motion to Suspend the Rules and Concur in the Senate Amendment",401,5,25,0,431
433285,216674,2012-09-20,House,"On Passage",250,164,15,0,429
433285,221205,2012-09-20,House,"On Passage",250,164,15,0,429
433319,216856,2012-09-21,Senate,"On Cloture on the Motion to Proceed S. 3525",84,7,9,0,100
433319,216857,2012-11-13,Senate,"On the Motion to Proceed S. 3525",92,5,3,0,100
433319,216858,2012-11-15,Senate,"On the Cloture Motion S. 3525",84,12,4,0,100
433319,216859,2012-11-26,Senate,"On the Motion (Motion to Waive all Applicable Budgetary Discipline Re: Amdt. No. 2875)",50,44,6,0,100
433326,216964,2012-11-13,House,"On Motion to Suspend the Rules and Pass",361,3,65,0,429
433326,219060,2012-11-13,House,"On Motion to Suspend the Rules and Pass",361,3,65,0,429
433349,216573,2012-09-13,House,"On Ordering the Previous Question",235,178,16,0,429
433349,216574,2012-09-13,House,"On Agreeing to the Resolution",232,182,15,0,429
433349,221012,2012-09-13,House,"On Ordering the Previous Question",235,178,16,0,429
433349,221013,2012-09-13,House,"On Agreeing to the Resolution",232,182,15,0,429
433350,216554,2012-09-13,House,"On Agreeing to the Resolution",232,182,15,0,429
433350,220985,2012-09-13,House,"On Agreeing to the Resolution",232,182,15,0,429
433537,216848,2012-09-20,House,"On Ordering the Previous Question",238,179,12,0,429
433537,216849,2012-09-20,House,"On Agreeing to the Resolution",233,182,14,0,429
433537,218806,2012-09-20,House,"On Ordering the Previous Question",238,179,12,0,429
433537,218807,2012-09-20,House,"On Agreeing to the Resolution",233,182,14,0,429
433542,216578,2012-09-20,House,"On Motion to Suspend the Rules and Pass",257,158,14,0,429
433542,216579,2012-11-30,House,"On Motion to Recommit with Instructions",157,231,44,0,432
433542,216580,2012-11-30,House,"On Passage",245,139,48,0,432
433542,221027,2012-09-20,House,"On Motion to Suspend the Rules and Pass",257,158,14,0,429
433542,221028,2012-11-30,House,"On Motion to Recommit with Instructions",157,231,44,0,432
433542,221029,2012-11-30,House,"On Passage",245,139,48,0,432
433659,216364,2012-09-22,Senate,"On Passage of the Bill S. 3576",10,81,9,0,100
433690,217071,2012-12-20,House,"On Motion to Suspend the Rules and Pass",422,0,9,0,431
433690,219568,2012-12-20,House,"On Motion to Suspend the Rules and Pass",422,0,9,0,431
433850,216977,2012-12-19,House,"On Motion to Suspend the Rules and Pass",409,1,21,0,431
433850,219135,2012-12-19,House,"On Motion to Suspend the Rules and Pass",409,1,21,0,431
434261,216494,2012-12-18,House,"On Motion to Suspend the Rules and Pass",359,36,36,0,431
434261,220768,2012-12-18,House,"On Motion to Suspend the Rules and Pass",359,36,36,0,431
435947,216794,2012-12-04,House,"On Motion to Suspend the Rules and Pass, as Amended",398,2,31,0,431
435947,221644,2012-12-04,House,"On Motion to Suspend the Rules and Pass, as Amended",398,2,31,0,431
435958,216307,2012-11-15,House,"On Ordering the Previous Question",243,164,25,0,432
435958,216308,2012-11-15,House,"On Agreeing to the Resolution",253,150,30,0,433
435958,220251,2012-11-15,House,"On Ordering the Previous Question",243,164,25,0,432
435958,220252,2012-11-15,House,"On Agreeing to the Resolution",253,150,30,0,433
435995,216201,2012-12-05,House,"On Motion to Suspend the Rules and Pass",392,0,39,0,431
435995,219868,2012-12-05,House,"On Motion to Suspend the Rules and Pass",392,0,39,0,431
436553,216499,2012-12-18,House,"On Motion to Suspend the Rules and Pass",388,4,39,0,431
436553,220831,2012-12-18,House,"On Motion to Suspend the Rules and Pass",388,4,39,0,431
436621,216785,2012-12-11,Senate,"On Cloture on the Motion to Proceed S. 3637",76,20,4,0,100
436621,216786,2012-12-13,Senate,"On the Motion (Motion to Waive All Applicable Budgetary Discipline Re: S.3637)",50,42,8,0,100
436622,216984,2012-11-29,House,"On Agreeing to the Resolution",243,170,19,0,432
436622,219161,2012-11-29,House,"On Agreeing to the Resolution",243,170,19,0,432
436716,216941,2012-12-31,House,"On Motion to Suspend the Rules and Pass",404,0,27,0,431
436716,219013,2012-12-31,House,"On Motion to Suspend the Rules and Pass",404,0,27,0,431
436726,216483,2012-12-18,House,"On Motion to Suspend the Rules and Pass, as Amended",308,89,34,0,431
436726,220701,2012-12-18,House,"On Motion to Suspend the Rules and Pass, as Amended",308,89,34,0,431
437059,216183,2012-12-12,House,"On Ordering the Previous Question",224,183,24,0,431
437059,216184,2012-12-12,House,"On Agreeing to the Resolution",226,178,27,0,431
437059,219803,2012-12-12,House,"On Ordering the Previous Question",224,183,24,0,431
437059,219804,2012-12-12,House,"On Agreeing to the Resolution",226,178,27,0,431
437514,216466,2012-12-19,House,"On Motion to Suspend the Rules and Pass",330,77,24,0,431
437514,220646,2012-12-19,House,"On Motion to Suspend the Rules and Pass",330,77,24,0,431
438798,216780,2012-12-20,House,"On Ordering the Previous Question",233,184,14,0,431
438798,216781,2012-12-20,House,"On Agreeing to the Resolution",219,197,15,0,431
438798,221563,2012-12-20,House,"On Ordering the Previous Question",233,184,14,0,431
438798,221564,2012-12-20,House,"On Agreeing to the Resolution",219,197,15,0,431
438800,216791,2012-12-20,House,"On Ordering the Previous Question",233,186,12,0,431
438800,216792,2012-12-20,House,"On Agreeing to the Resolution",243,177,11,0,431
438800,221627,2012-12-20,House,"On Ordering the Previous Question",233,186,12,0,431
438800,221628,2012-12-20,House,"On Agreeing to the Resolution",243,177,11,0,431
438804,216181,2012-12-20,House,"On Motion to Recommit with Instructions",179,243,9,0,431
438804,216182,2012-12-20,House,"On Passage",215,209,7,0,431
438804,219797,2012-12-20,House,"On Motion to Recommit with Instructions",179,243,9,0,431
438804,219798,2012-12-20,House,"On Passage",215,209,7,0,431
438805,216431,2012-12-19,House,"On Motion to Suspend the Rules and Pass",383,16,32,0,431
438805,220601,2012-12-19,House,"On Motion to Suspend the Rules and Pass",383,16,32,0,431
440117,220303,2013-01-01,House,"On Motion to Suspend the Rules and Pass",287,129,15,0,431
440122,220305,2013-01-01,House,"On Agreeing to the Resolution",408,10,14,0,432
